C6EHH5_ECOBD	MQRLFLLVAVMLLSGCLTAPPKEAARPTLMPRAQSYKDLTHLPAPTGKIFVSVYNIQDETGQFKPYPASNFSTAVPQSATAMLVTALKDSRWFIPLERQGLQNLLNERKIIRAAQENGTVAINNRIPLQSLTAANIMVEGSIIGYESNVKSGGVGARYFGIGADTQYQLDQIAVNLRVVNVSTGEILSSVNTSKTILSYEVQAGVFRFIDYQRLLEGEVGYTSNEPVMLCLM	CSGG_ECOLI	I
C6EKC9_ECOBD	MSPCKLLPFCVALALTGCSLAPDYQRPAMPVPQQFSLSQNGLVNAADNYQNVGWRTFFVDNQVKTLISEALVNNRDLRMATLKVQEARAQYRLTDADRYPQLNGEGSGSWSGNLKGNTATTREFSTGLNASFDLDFFGRLKNMSEAERQNYLATEEAQRAVHILLVSNVAQSYFNQQLAYAQLQIAEETLRNYQQSYAFVEKQLLTGSSNVLALEQARGVIESTRSDIAKRQ	CUSC_ECOLI	I
C6EHD4_ECOBD	MIAMQKNAAHTYAISSLLVLSLTGCAWIPSTPLVQGATSAQPVPGPTPVANGSIFQSAQPINYGYQPLFEDRRPRNIGDTLTIVLQENVSASKSSSANASRDGKTNFGFDTVPRYLQGLFGNARADVEASGGNTFNGKGGANASNTFSGTLTVTVDQVLVNGNLHVVGEKQIAINQGTEFIRFSGVVNPRTISGSNTVPSTQVADARIEYVGNGYINEAQNMGWLQRFFLNL	FLGH_ECOLI	I
C6EHM1_ECOBD	MRPLILSIFALFLAGCKHSQQSMVDTFRASLFDNQDITVADQQIQALPYSTMYLRLNEGQRIFVVLGYIEQEQSKWLSQDNAMLVTHNGRLLKTVKLNNNLLEVTNSGQDPLRNALAIKDGSRWTRDILWSEDNHFRSATLSSTFSFAGLETLNIAGRNVLCNVWQEEVTSTRPEKQWQNTFWVDSATGQVRQSRQMLGAGVIPVEMTFLKPAP	GFCB_ECOLI	I
C6ED44_ECOBD	MINRQLSRLLLCSILGSTTLISGCALVRKDSAPHQQLKPEQIKLADDIHLASSGWPQAQWWKQLNDPQLDALIQRTLSGSHTLAEAKLREEKAQSQADLLDAGSQLQVAALGMLNRQRVSANGFLSPYSMDAPALGMDGPYYTEATVGLFAGLDLDLWGVHRSAVAAAIGAHNAALAETAAVELSLATGVAQLYYSMQASYQMLDLLEQTHDVIDYAVKAHQSKVAHGLEAQ	MDTP_ECOLI	I
C6EAH3_ECOBD	MNRDSFYPAIACFPLLLMLAGCAPMHETRQALSQQTPAAQVDTALPTALKNGWPDSQWWLEYHDNQLTSLINNALQNAPDMQVAEQRIQLAEAQAKAVATQDGPQIDFSADMERQKMSAEGLMGPFALNDPAAGTTGPWYTNGTFGLTAGWHLDIWGKNRAEVTARLGTVKARAAEREQTRQLLAGSVARLYWEWQTQAALNTVLQQIEKEQNTIIATDRQLYQNGITSSVE	MDTQ_ECOLI	I
C6ECP9_ECOBD	MRFCLILITALLLAGCSHHKAPPPNARLSDSITVIAGLNDQLQSWHGTPYRYGGMTRRGVDCSGFVVVTMRDRFDLQLPRETKQQASIGTQIDKDELLPGDLVFFKTGSGQNGLHVGIYDTNNQFIHASTSKGVMRSSLDNVYWQKNFWQARRI	NLPC_ECOLI	I
C6ED49_ECOBD	MKQPKIPVKMLTTLTILMVFLCVGSYLLSPKWQAVRAEYQRQRDPLHQFASQQTPEAQLQALQDKIRANPQNSEQWALLGEYYLWQNDYSNSLLAYRQALQLHGENAELYAALATVLYYQASQHMTAQTRAMIDKALALDSNEITALMLLASDAFMQANYAQAIELWQKVMDLNSPRINRTQLVESINMAKLLQRRSD	NRFG_ECOLI	I
C6EFV1_ECOBD	MFVTSKKMTAAVLAITLAMSLSACSNWSKRDRNTAIGAGAGALGGAVLTDGSTLGTLGGAAVGGVIGHQVGK	OSMB_ECOLI	I
C6EHI4_ECOBD	MLRNGNKYLLMLVSIIMLTACISQSRTSFIPPQDRESLLAEQPWPHNGFVAISWHNVEDEAADQRFMSVRTSALREQFAWLRENGYQPVSIAQIREAHRGGKPLPEKAVVLTFDDGYQSFYTRVFPILQAFQWPAVWAPVGSWVDTPADKQVKFGDELVDREYFATWQQVREVARSRLVELASHTWNSHYGIQANATGSLLPVYVNRAYFTDHARYETAAEYRERIRLDAVK	PGAB_ECOLI	I
C6EAP5_ECOBD	MMKSKMKLMPLLVSVTLISGCTVLPGSNMSTMGKDVIKQQDADFDLDKMVNVYPLTPRLIDQLRPRPNVARPNMTLESEIANYQYRVGPGDVLNVTVWDHPELTTPAGQYRSSSDTGNWVQPDGTMFYPYIGKVHVVGKTLAEIRSDITGRLATYIADPQVDVNIAAFRSQKAYISGQVNKSGQQAITNVPLTILDAINAAGGLTDTADWRNVVLTHNGREERISLQALMQN	WZA_ECOLI	I
C6EA91_ECOBD	MDKPKAYYRLLLPSFLLLSACTVDISQPDSSATAVDAGAKTWAVKFQHQSSFTEQSIKEITAPDLKPGDLLFSSSLGVTSFGIRVFSTSSVSHVAIFLGDNNVAEATGAGVQIVSLKKAMKHSDKLFVLRVPDLTPQQATDITAFANKIKDSGYNYRGIVEFIPFMVTRQMCSLNPFSEDFRQQCVSGLAKAQLSSVGEGDKKSWFCSEFVTDAFAKAGHPLTLAQSGWISP	YAEF_ECOLI	I
C6EA74_ECOBD	MNLRRVCCICVLFSLLAGCASESSIDEKKKKAQVTQSNINKNTPQQLTDKDLFGNETTLAVSEEDIQAALDGDEFRVPLNSPVILVQSGNRASETIMQEEMRKYYTVSTFSGIPDRQKPLTCNKNKDKNENEDVASAENMNWMQALRFVAAKGHQKAIIVYQDMLQTGKYDSALKSTVWSDYKNDKLTDAISLRYLVRFTLVDVATGEWATWSPVNYEYKVLPPLPDKNEAS	YAFT_ECOLI	I
C6EKW6_ECOBD	MKYSSIFSMLSFFILFACNETAVYGSDENIIFMRYVEKLHLDKYSVKNTVKTETMAIQLAEIYVRYRYGERIAEEEKPYLITELPDSWVVEGAKLPYEVAGGVFIIEINKKNGCVLNFLHSK	YBBC_ECOLI	I
C6EJQ2_ECOBD	MKKLILIAMMASGLVACAQSTAPQEDSRLKEAYSACINTAQGSPEKIEACQSVLNVLKKEKQHQQFADQESVRVLDYQQCLRATQTGNDQAVKADCDKVWQEIRSNNK	YBFN_ECOLI	I
C6EJP5_ECOBD	MKTNRSLVVIVSLITATLLLTACAQPEQSSLAGDWLLTPKDKTRGLTGSIAVNIAPFRCKTNCRGDNLPDNTRRWQLSGGNEKELTYLHNMSAQEKVGLNPGWQCYTSFFMRVCQGKPGTRPIVNEDYVSESGFFGSMMHVGIIELRRCQSENCQQELKAINTH	YBFP_ECOLI	I
C6EHG2_ECOBD	MRLIVVSIMVTLLSGCGSIISRTIPGQGHGNQYYPGVQWDVRDSAWRYVTILDLPFSLVFDTLLLPIDIHHGPYE	YCEK_ECOLI	I
C6EFS2_ECOBD	MIKSKIVLLSALVSCALISGCKEENKTNVSIEFMHSSVEQERQAVISKLIARFEKENPGITVKQVPVEEDAYNTKVITLSRSGSLPEVIETSHDYAKVMDKEQLIDRKAVATVISNVGEGAFYDGVLRIVRTEDGSAWTGVPVSAWIGGIWYRKDVLAKAGLEEPKNWQQLLDVAQKLNDPANKKYGIALPTAESVLTEQSFSQFALSNQANVFNAEGKITLDTPEMMQALT	YCJN_ECOLI	I
C6EEW6_ECOBD	MRAAFWVGCAALLLSACSSEPVQQATAAHVAPGLKASMSSSGEANCAMIGGSLSVARQLDGTAIGMCALPNGKRCSEQSLAAGSCGSY	YDBJ_ECOLI	I
C6EEM6_ECOBD	MDICSRNEKLAIRRPAILVALALLLCSCKSTPPESMVTPPAGSKPPATTQQSSQPMRGIWLATVSRLDWPPVSSVNISNPTSRARVQQQAMIDKLDHLQRLGINTVFFQVKPDGTALWPSKILPWSDLMTGKIGENPGYDPLQFMLDEAHKRGMKVHAWFNPYRVSVNTKPGTIRELNSTLSQQPASVYVQHRDWIRTSGDRFVLDPGIPDVQDWITSIVAEVVSRYPVDGV	YDDW_ECOLI	I
C6EBF5_ECOBD	MRLLILTLSLITLAGCTVTRQAHVSEVDAATGIVRLVYDQAFLQHAHTDRYVSRGIADRACQQEGYTHAVPFGQPVGNCSLFAGSLCLNTEFTLSYQCHHSAFPVFL	YECR_ECOLI	I
C6EBD3_ECOBD	MKKLAIAGALLLLAGCAEVENYNNVVKTPAPDWLAGYWQTKGPQRALVSPEAIGSLIVTKEGDTLDCRQWQRVIAVPGKLTLMSDDLTNVTVKRELYEVERDGNTIEYDGMTMERVDRPTAECAAALDKAPLPTPLP	YEDD_ECOLI	I
C6EAI9_ECOBD	MKAFNKLFSLVVASVLVFSLAGCGDKEESKKFSANLNGTEIAITYVYKGDKVLKQSSETKIQFASIGATTKEDAARTLEPLSAKYKNIAGVEEKLTYTDTYAQENVTIDMEKVDFKALQGISGINVSAEDAKKGITMAQMELVMKAAGFKEVK	YEHR_ECOLI	I
C6EKK4_ECOBD	MKFKKCLLPVAMLASFTLAGCQSNADDHAADVYQTDQLNTKQETKTVNIISILPAKVAVDNSQNKRNAQAFGALIGAVAGGVIGHNVGSGSNSGTTAGAVGGGAVGAAAGSMVNDKTLVEGVSLTYKEGTKVYTSTQVGKECQFTTGLAVVITTTYNETRIQPNTKCPEKS	YFGH_ECOLI	I
C6EJY7_ECOBD	MIKHLVAPLIFTSLILTGCQSPQGKFTPEQVAAMQSYGFTESAGDWSLGLSDAILFAKNDYKLLPESQQQIQTMAAKLASTGLTHARMDGHTDNYGEDSYNEGLSLKRANVVADAWAMGGQIPRSNLTTQGLGKKYPIASNKTAQGRAENRRVAVVITTP	YFIB_ECOLI	I
C6EGJ3_ECOBD	MKRLIPVALLTALLAGCAHDSPCVPVYDDQGRLVHTNTCMKGTTQDNWETAGAIAGGAAAVAGLTMGIIALSK	YHDV_ECOLI	I
C6EFK7_ECOBD	MNKFIKVALVGAVLATLTACTGHIENRDKNCSYDYLLHPAISISKIIGGCGPTAQ	YHFL_ECOLI	I
C6ED74_ECOBD	MKLNFKGFFKAAGLFPLALMLSGCISYALVSHTAKGSSGKYQSQSDTITGLSQAKDSNGTKGYVFVGESLDYLITDGADDIVKMLNNPALNRHNIQVADDARFVLNAGKKKFTGTISLYYYWNNEEEKALATHYGFACGVQHCTRSLENLKGTIHEKNKNMDYSKVMAFYHPFKVRFYEYYSPRGIPDGVSAALLPVTVTLDIITAPLQFLVVYAVNQ	YIDX_ECOLI	I
C6EDZ7_ECOBD	MKRPALILICLLLQACSATTKELGNSLWDSLFGTPGVQLTDDDIQNMPYASQYMQLNGGPQLFVVLAFAEDGQQKWVTQDQATLVTQHGRLVKTLLGGDNLIEVNNLAADPLIKPAQIIDGATWTRTMGWTEYKQVRYATARSVFKWNGTDTVKVGSDETPVRVLDEEVSTDQARWHNRYWIDSVGQIRQSEQYLGADYFPVKTTLIKAAKQ	YJBF_ECOLI	I
C6EL92_ECOBD	MKVNLILFSLFLLVSIMACNVFAFSISGGVSERSYKETEKTSAMTTTHSTKLQPSQAILFKMREDAPPLNLTEEITPTYPTKANYLIHPVR	YPDI_ECOLI	I
C6EHX9_ECOBD	MKTIFTVGAVVLATCLLSGCVNEQKVNQLASNVQTLNAKIARLEQDMKALRPQIYAAKSEANRANTRLDAQDYFDCLRCLRMYAE	YQHH_ECOLI	I
C6EEB8_ECOBD	MMMNAFFPAMALMVLVGCSTPPPEQKAQRVKVDPIRSLNMEALCKDQAAKRYNTGEQKIDVTAFEQFQGSYEMRGYTFRKEQFVCSFDADGHFLHLSMR	YSAB_ECOLI	I
C6EDI8_ECOBD	MNLKKIFFSAVTVSVLCALTGCDYIQEGKPESSLLKQEEEHNNKIVLLEKQQAQLKSQLETIQKQQTGIINSTKTLTHVIKSVKDQQNTFIFTEFNPAKTKYFILNNGSVALAGRVLSIDATENGSVIHISLVNLLSIPISNIGFNATWGGEKPVDAKEFARWQQLLFNTSMTSTLKLLPGQWQDINLTLKGVSPNNLGYLKLAINMENIQFDNLPAADNRQKRSKK		I
C6EEZ8_ECOBD	MKKSTLSLAIGLLLACSTGMAKTQHLTLEQRMALLEERLEAAEMRAAKAEGQVKQLQTQQAAEIREIKAAQGNTPVNGQTTAESAKKNATSPNLLLSGYGDLKIYGDVEFNMDAESNHGLLAMTNADVNSDPTNEQWNLNGRILLGFDGMRKLDNGYFAGFSAQPLGDMHGSVNIDDAVFFFGKENDWKVKVGRFEAYDMFPLNQDTFVEHSGNTANDLYDDGSGYIYMMKE		I
C6EFM3_ECOBD	MSRVAAIIYALVICIIVCLSWAVNHYRDNATAYKEQRDKNARELKLANAAITDMQMRQRDVAALDAKYTKELADAKAENDALRDDVAAGRRRLHIKAVCQSVREATTASGVDNAASPRLADTAERDYFTLRERLVMMQAQLEGAQQYITEQCLK		I
C6EJF9_ECOBD	MSRVTAIISALVICIIVCLSWAVNHYRDNAITYKAQRDKNARELKLANAAITDMQMRQRDVAALDAKYTKELADAKAENDALRDDVAAGRRRLHIKAVCQSVREATTASGVDNAASPRLADTAERDYFTLRERLITMQKQLEGTQKYINEQCR		I
C6EG83_ECOBD	MFRRNLITSAILLMAPLAFSAQSLAESLTVEQRLELLEKALRETQSELKKYKDEEKKKYTPATVNRSVSTNDQGYAANPFPTSSAAKPDAVLVKNEEKNASETGSIYSSMTLKDFSKFVKDEIGFSYNGYYRSGWGTASHGSPKSWAIGSLGRFGNEYSGWFDLQLKQRVYNENGKRVDAVVMMDGNVGQQYSTGWFGDNAGGENFMQFSDMYVTTKGFLPFAPEADFWVGK	BGLH_ECOLI	H
C6EBR6_ECOBD	MSYLNLRLYQRNTQCLHIRKHRLAGFFVRLVVACAFAAQAPLSSADLYFNPRFLADDPQAVADLSRFENGQELPPGTYRVDIYLNNGYMATRDVTFNTGDSEQGIVPCLTRAQLASMGLNTASVAGMNLLADDACVPLTTMVQDATAHLDVGQQRLNLTIPQAFMSNRARGYIPPELWDPGINAGLLNYNFSGNSVQNRIGGNSHYAYLNLQSGLNIGAWRLRDNTTWSYNS	FIMD_ECOLI	H
C6EFI5_ECOBD	MKQWIAALLLMLIPGVQAAKPQKVTLMVDDVPVAQVLQALAEQEKLNLVVSPDVSGTVSLHLTDVPWKQALQTVVKSAGLITRQEDNILSVHSIAWQNNNIARQEAEQARAQANLPLENRSITLQYADAGELAKAGEKLLSAKGSMTVDKRTNRLLLRDNKTALSALEQWVAQMDLPVGQVELSAHIVTINEKSLRELGVKWTLADAQHAGGVGQVTTLGSDLSVATATTHV	HOFQ_ECOLI	H
C6EAE5_ECOBD	MTIKPTKNYHNHLTRIATFCALLYCNSAFCAELVEYDHTFLMGQNASNIDLSRYSEGNPAIPGMYDLSVYVNDQPIINQSITFIEIEGKKNAQACITLKNLLQFHINSPDINNEKAVLLARDETLGNCLNLTKIIPQASVRYDVNEQRLDIDVPQAWVMKNYQNYVDPSLWENGINAAMLSYNLNGYHSETPGRRNDSIYAAFNGGMNLGAWRLRASGNYNWMTDSGSNYDF	HTRE_ECOLI	H
C6EDY6_ECOBD	MMITLRKLPLAVAVAAGVMSAQAMAVDFHGYARSGIGWTGSGGEQQCFQTTGAQSKYRLGNECETYAELKLGQEVWKEGDKSFYFDTNVAYSVAQQNDWEATDPAFREANVQGKNLIEWLPGSTIWAGKRFYQRHDVHMIDFYYWDISGPGAGLENIDVGFGKLSLAATRSSEAGGSSSFASNNIYDYTNETANDVFDVRLAQMEINPGGTLELGVDYGRANLRDNYRLVDG	LAMB_ECOLI	H
C6EFR3_ECOBD	MKKLLPCTALVMCAGMACAQAEERNDWHFNIGAMYEIENVEGYGEDMDGLAEPSVYFNAANGPWRIALAYYQEGPVDYSAGKRGTWFDRPELEVHYQFLENDDFSFGLTGGFRNYGYHYVDEPGKDTANMQRWKIAPDWDVKLTDDLRFNGWLSMYKFANDLNTTGYADTRVETETGLQYTFNETVALRVNYYLERGFNMDDSRNNGEFSTQEIRAYLPLTLGNHSVTPYTR	OMPG_ECOLI	H
C6EF26_ECOBD	MKNINAIILLSSLTSASVFAGAYVENREAYNLASDQGEVMLRVGYNFDMGAGIMLTNTYTFQREDELKHGYNEIEGWYPLFKPTDKLTIQPGGLINDKSIGSGGAVYLDVNYKFVPWFNLTVRNRYNHNNYSSTDLSGELDNNDTYEIGTYWNFKITDKFSYTFEPHYFIRVNDFNSSNGKDHHWEITNTFRYRINEHWLPYFELRWLDRNVEPYHREQNQIRIGTKYFF	OMPL_ECOLI	H
C6EEW8_ECOBD	MKSKVLALLIPALLAAGAAHAAEVYNKDGNKLDLYGKVDGLHYFSDNSAKDGDQSYARLGFKGETQINDQLTGYGQWEYNIQANNTESSKNQSWTRLAFAGLKFADYGSFDYGRNYGVMYDIEGWTDMLPEFGGDSYTNADNFMTGRANGVATYRNTDFFGLVNGLNFAVQYQGNNEGASNGQEGTNNGRDVRHENGDGWGLSTTYDLGMGFSAGAAYTSSDRTNDQVNHTA	OMPN_ECOLI	H
C6EFY0_ECOBD	MKKLTVAALAVTTLLSGSAFAHEAGEFFMRAGSATVRPTEGAGGTLGSLGGFSVTNNTQLGLTFTYMATDNIGVELLAATPFRHKIGTRATGDIATVHHLPPTLMAQWYFGDASSKFRPYVGAGINYTTFFDNGFNDHGKEAGLSDLSLKDSWGAAGQVGVDYLINRDWLVNMSVWYMDIDTTANYKLGGAQQHDSVRLDPWVFMFSAGYRF	OMPW_ECOLI	H
C6EHI3_ECOBD	MYSSSRKRCPKTKWALKLLTAAFLAASPAAKSAVNNAYDALIIEARKGNTQPALSWFALKSALSNNQIADWLQIALWAGQDKQVITVYNRYRHQQLPARGYAAVAVAYRNLQQWQNSLTLWQKALSLEPQNKDYQRGQILTLADAGHYDTALVKLKQLNSGAPDKANLLAEAYIYKLAGRHQDELRAMTESLPENASTQQYPTEYVQALRNNQLAAAIDDANLTPDIRADIH	PGAA_ECOLI	H
C6EA44_ECOBD	MKKSTLALVVMGIVASASVQAAEIYNKDGNKLDVYGKVKAMHYMSDNDSKDGDQSYIRFGFKGETQINDQLTGYGRWEAEFAGNKAESDTAQQKTRLAFAGLKYKDLGSFDYGRNLGALYDVEAWTDMFPEFGGDSSAQTDNFMTKRASGLATYRNTDFFGVIDGLNLTLQYQGKNENRDVKKQNGDGFGTSLTYDFGGSDFAISGAYTNSDRTNEQNLQSRGTGKRAEAWA	PHOE_ECOLI	H
C6EKT4_ECOBD	MKIPTTTDIPQRYTWCLAGICYSSLAILPSFLSYAESYFNPAFLLENGTSVADLSRFERGNHQPAGVYRVDLWRNDEFIGSQDIVFESTTENTGDKSGGLMPCFNQVLLERIGLNSSAFPELAQQQNNKCINLLKAVPDATINFDFAAMRLNITIPQIALLSSAHGYIPPEEWDEGIPALLLNYNFTGNRGNGNDSYFFSELSGINIGPWRLRNNGSWNYFRGNGYHSEQWN	SFMD_ECOLI	H
C6EDN2_ECOBD	MRKIVAMAVICLTAASGLTSAYAAQLADDEAGLRIRLKNELRRADKPSAGAGRDIYAWVQGGLLDFNSGYYSNIIGVEGGAYYVYKLGARADMSTRWYLDGDKSFGFALGAVKIKPSENSLLKLGRFGTDYSYGSLPYRIPLMAGSSQRTLPTVSEGALGYWALTPNIDLWGMWRSRVFLWTDSTTGIRDEGVYNSQTGKYDKHRARSFLAASWHDDTSRYSLGGSVQKDVS	UIDC_ECOLI	H
C6EA33_ECOBD	MRVNLLITMIIFALIWPVTALRAAVSKTTWADAPAREFVFVENNSDDNFFVTPGGALDPRLTGANRWTGLKYTGSGTIYQQSLGYIDNGYNTGLYTNWKFDMWLENSPVSSPLTGLRCINWYAGCNMTTSLILPQTTDASGFYGATVTSGGAKWMHGMLSDAFYQYLQQMPVGSSFTMTINACQTSVNYDASSGARCKDQASGNWYVRNVTHTKAANLRLINTHSLAEVFIN	YAGW_ECOLI	H
C6EJQ3_ECOBD	MRTFSGKRSTLALAIAGVTAMSGFMAMPEARAEGFIDDSTLTGGIYYWQRERDRKDVTDGDKYKTNLSHSTWNANLDFQSGYAADMFGLDIAAFTAIEMAENGDSSHPNEIAFSKSNKAYDEDWSGDKSGISLYKAAAKFKYGPVWARAGYIQPTGQTLLAPHWSFMPGTYQGAEAGANFDYGDAGALSFSYMWTNEYKAPWHLEMDEFYQNDKTTKVDYLHSLGAKYDFKN	YBFM_ECOLI	H
C6EJM0_ECOBD	MDTVNIYRLSFVSCLVMAMPCALAVEFNLNVLDKSMRDRIDISLLKEKGVIAPGEYFVSVAVNNNQISNGQKINWQKKGDKTIPCINDSLVDKFGLKPDIRQSLPQIDRCIDFSSRPEMLFNFDQANQQLNISIPQAWLAWHSENWAPPSTWKEGVAGVLMDYNLFASNYRPQDGSSSTNLNAYGTTGINAGSWRLRSDYQLNNTDSEDSHEQSGGISRTYLFRPLPQLGSK	YBGQ_ECOLI	H
C6EI42_ECOBD	MYRTHRQHSLLSSGGVPSFIGGLVVFVSAAFNAQAETWFDPAFFKDDPSMVADLSRFEKGQKITPGGYRVDIVLNQTIVDTRNVNFVEITPEKGIAACLTTESLDAMGVNTDAFPAFKQLDKQACVPLAEIIPDASVTFNVNKLRLEISVPQIAIKSNARGYVPPERWDEGINALLLGYSFSGANSIHSSADSDSGDSYFLNLNSGVNLGPWRLRNNSTWSRSSGQTAEWKN	YCBS_ECOLI	H
C6EGR5_ECOBD	MGIKQHNGNTKADRLAELKIRSPSIQLIKFGAIGLNAIIFPPLLIAADTGSQYGTNITINDGDRITGDTADPSGNLYSVMTPAGNTPGNINLGNDVTVNVNDASGYAKGIIIQGKNSSLTANRLTVDVVGQTSAIGINLIGDYTHADLGTGSTIKSNDDGIIIGHSSTLTATQFTIENSNGIGLTINDYGTSVDLGSGSKITTDGSTGVYIGGLNGNNANGAARFTATDLTI	YCGV_ECOLI	H
C6EB89_ECOBD	MATKKRSGEEINDRQILCGMGIKLRRLTAGICLITQLAFPMAAAAQGVVNAATQQPVPAQIAIANANTVPYTLGALESAQSVAERFGISVAELRKLNQFRTFARGFDNVRQGDELDVPAQVSEKKLTPPPGNSSDNLEQQIASTSQQIGSLLAEDMNSEQAANMARGWASSQASGAMTDWLSRFGTARITLGVDEDFSLKNSQFDFLHPWYETPDNLFFSQHTLHRTDERTQ	YEEJ_ECOLI	H
C6E9W8_ECOBD	MIASLFSANGVAAVTDSCQGYDVKASCQASRQSLSGITQDWSIADGQWLVFSDMTNNASGGAVFLQQGAEFSLLPENETGMTLFANNTVTGEYNNGGAIFAKENSTLNLTDVIFSGNVAGGYGGAIYSSGTNDTGAVDLRVTNAMFRNNIANDGKGGAIYTINNDVYLSDVIFDNNQAYTSTSYSDGDGGAIDVTDNNSDSKHPSGYTIVNNTAFTNNTAEGYGGAIYTNSV	YFAL_ECOLI	H
C6EED3_ECOBD	MIIKKSGGRWQLSLLASVVISAFFLNTAYAWQQEYIVDTQPGHSTERYTWDSDHQPDYNDILSQRIQSSQRALGLEVNLAEETPVDVTSSMSMGWNFPLYEQVTTGPVAALHYDGTTTSMYNEFGDSTTTLTDPLWHASVSTLGWRVDSRLGDLRPWAQISYNQQFGENIWKAQSGLSRMTATNQNGNWLDVTVGADMLLNQNIAAYAALSQAENTTNNSDYLYTMGVSARF	YHJY_ECOLI	H
C6EHU9_ECOBD	MDQMYKKLKLTTISELIKNIYCSLSVIIIGCASAYAVEFNKDLIEAEDRENVNLSQFETDGQLPVGKYSLSTLINNKRTPIHLDLQWVLIDNQTAVCVTPEQLTLLGFTDEFIEKTQQNLIDGCYPIEKEKQITTYLDKGKMQLSISAPQAWLKYKDANWTPPELWNHGIAGAFLDYNLYASHYAPHQGDNSQNISSYGQAGVNLGAWRLRTDYQYDQSFNNGKSQATNLDF	YQIG_ECOLI	H
C6EHU8_ECOBD	MRYLNTKNIIAAGVLLSCMSSIAWGAIIPDRTRIIMNESDKGEALKLTNQSKNLPYLAQTWIEDTKGNKSRDFIVTVPPMVRLNPSEQIQIRMITQEKIAQLPKDRETLFYFNVREIPPKTDKKNVMQVTMQHALKLFWRPKAIELEDDGVMTYEKVEIIRRNDGSIRFNNKMPYHVTLGYIGTNGVTMLPQTQSLMVTPFSYANTQFKNVPSTFQVGYINDFGGLSFYEIN	YQIH_ECOLI	H
C6EH81_ECOBD	MPQRHHQGHKRTPKQLALIIKRCLPMVLTGSGMLCTTANAEEYYFDPIMLETTKSGMQTTDLSRFSKKYAQLPGTYQVDIWLNKKKVSQKKITFTANAEQLLQPQFTVEQLRELGIKVDEIPALAEKDDDSVINSLEQIIPGTAAEFDFNHQRLNLSIPQIALYRDARGYVSPSRWDDGIPTLFTNYSFTGSDNRYRQGNRSQRQYLNMQNGANFGPWRLRNYSTWTRNDQT	YRAJ_ECOLI	H
C6EDI7_ECOBD	MNKIFKVIWNPATGNYTVTSETAKSRGKKSGRSKLLISALVAGGLLSSFGALANAGNDNGQGVDYGSGSAGDGWVAIGKGAKANTFMNTSGSSTAVGYDAIAEGQYSSAIGSKPHAIGGASMAFGVSAISEGDRSIALGASSYSLGQYSMALGRYSKALGKLSIAMGDSSKAEGANAIALGNATKATEIMSIALGDTANASKAYSMALGASSVASEENAIALGRSSVASGTD	AG43_ECOLI	H
C6ELT1_ECOBD	MSHYKTGHKQPRFRYSVLARCVAWANISVQVLFPLAVTFTPVMAARAQHAVQPRLSMGNTTVTADNNVEKNVASFAANAGTFLSSQPDSDATRNFITGMATAKANQEIQEWLGKYGTARVKLNVDKDFSLKDSSLEMLYPIYDTPTNMLFTQGAIHRTDDRTQSNIGFGWRHFSGNDWMAGVNTFIDHDLSRSHTRIGVGAEYWRDYLKLSANGYIRASGWKKSPDVEDYQE	EAEH_ECOLI	H
C6ELL4_ECOBD	MHSWKKKLVVSQLALACTLAITSQANAANYDTWTYIDNPVTALDWDHMDKAGTVDGNYVNYSGFVYYNNTNGDFDQSFNGDTVNGTISTYYLNHDYADSTANQLDISNSVIHGSITSMLPGGYYDRFDADGNNLGGYDFYTDAVVDTHWRDGDVFTLNIANTTIDDDYEALYFTDSYKDGDVTKHTNETFDTSEGVAVNLDVESNINISNNSRVAGIALSQGNTYNETYTTE	YAIT_ECOLI	H
C6EB78_ECOBD	MLYNIPCRIYILSTLSLCISGIVSTATATSSETKISNEETLVVTTNRSASNLWESPATIQVIDQQTLQNSTNASIADNLQDIPGVEITDNSLAGRKQIRIRGWICPYISRHLLSLNPLQARCRRYSRGER	YOEA_ECOLI	H
C6EDC0_ECOBD	MNKNIRILQFLVSIIYSVQSHFSGAQTIQLNGNGIPKSITRSITGVDGNAALNISVPYKTSYTQNILSVESSINIKGGTSNTSIGGAGVYGENFTLNNNGSVWGGDGYNGGIAVSGNKISINNYRNVYGGNGLGGSGSSGGAGLSGDDIIVDNYRSIYGGDDVGGTGGSGVTGSNITVHNSGGILGGNGVNGGDGINGSNLFITNDNMISGGYGIKQGGDAISGNQITLNNN	YUAQ_ECOLI	H
C6ED35_ECOBD	MNKYLKYFSGTLVGLMLSTSAFAAAEYAVVLKTLSNPFWVDMKKGIEDEAKTLGVSVDIFASPSEGDFQSQLQLFEDLSNKNYKGIAFAPLSSVNLVMPVARAWKKGIYLVNLDEKIDMDNLKKAGGNVEAFVTTDNVAVGAKGASFIIDKLGAEGGEVAIIEGKAGNASGEARRNGATEAFKKASQIKLVASQPADWDRIKALDVATNVLQRNPNIKAIYCANDTMAMGVA	ALSB_ECOLI	G
C6ELL2_ECOBD	MKRSLLFSAVLCAASLTSVHAAQPITEPEFASDIVDRYADHIFYGSGATGMALVVIDGNQRVFRSYGETRPGNNVRPQLDSVVRIASLTKLMTSEMLVKLLDQGTVKLNDPLSKYAPPGARVPTYNGTPITLVNLATHTSALPREQPGGAAHRPVFVWPTREQRWKYLSTAKLKAAPGSQAAYSNLAFDLLADALANASGKPYTQLFEEQITRPLGMKDTTYTPSPDQCRRL	AMPH_ECOLI	G
C6EEA8_ECOBD	MKLAACFLTLLPGFAVAASWTSPGFPAFSEQGTGTFVSHAQLPKGTRPLTLNFDQQCWQPADAIKLNQMLSLQPCSNTPPQWRLFRDGEYTLQIDTRSGTPTLMISIQNAAEPVASLVRECPKWDGLPLTVDVSATFPEGAAVRDYYSQQIAIVKNGQIMLQPAATSNGLLLLERAETDTSAPFDWHNATVYFVLTDRFENGDPSNDQSYGRHKDGMAEIGTFHGGDLRGLT	AMY1_ECOLI	G
C6EBF9_ECOBD	MHKFTKALAAIGLAAVMSQSAMAENLKLGFLVKQPEEPWFQTEWKFADKAGKDLGFEVIKIAVPDGEKTLNAIDSLAASGAKGFVICTPDPKLGSAIVAKARGYDMKVIAVDDQFVNAKGKPMDTVPLVMMAATKIGERQGQELYKEMQKRGWDVKESAVMAITANELDTARRRTTGSMDALKAAGFPEKQIYQVPTKSNDIPGAFDAANSMLVQHPEVKHWLIVGMNDSTV	ARAF_ECOLI	G
C6EG14_ECOBD	MEFSFSPKLLVVAVAAALPLMANAADTPSTATARKGFAGYDHPNQYLVKPATTIADNMMPVMQHPAQDKETQQKLAELEKKTGKKPNVVVFLLDDVGWMDVGFNGGGVAVGNPTPDIDAVASQGLILTSAYSQPSSSPTRATILTGQYSIHHGILMPPMYGQPGGLQGLTTLPQLLHDQGYVTQAIGKWHMGENKESQPQNVGFDDFRGFNSVSDMYTEWRDVHVNPEVALS	ASLA_ECOLI	G
C6EIF4_ECOBD	MEFFKKTALAALVMGFSGAALALPNITILATGGTIAGGGDSATKSNYTVGKVGVENLVNAVPQLKDIANVKGEQVVNIGSQDMNDNVWLTLAKKINTDCDKTDGFVITHGTDTMEETAYFLDLTVKCDKPVVMVGAMRPSTSMSADGPFNLYNAVVTAADKASANRGVLVVMNDTVLDGRDVTKTNTTDVATFKSVNYGPLGYIHNGKIDYQRTPARKHTSDTPFDVSKLNE	ASPG2_ECOLI	G
C6EDQ1_ECOBD	MKKVLALVVAAAMGLSSAAFAAETATTPAPTATTTKAAPAKTTHHKKQHKAAPAQKAQAAKKHHKNAKAEQKAPEQKAQAAKKHAGKHSHQQPAKPAAQPAA	ASR_ECOLI	G
C6EEA9_ECOBD	MILTPIRRYGAMILMLLTLVFSSEVLAKTHTTTASQKSHLTKASNKQVSSKQEYSRNSAKSSSLPDLRKYPSGTPRKKAFLRTVMPYITSQNAAITAERNWLISKQYQGQWSPAERARLKDIAKRYKVKWSGNTRKIPWNTLLERVDIIPTSMVATMAAAESGWGTSKLARNNNNLFGMKCMKGRCTNAPGKVKGYSQFSSVKESVSAYVTNLNTHPAYSSFRKSRAQLRKA	BAX_ECOLI	G
C6EGY0_ECOBD	MKNVKTLIAAAILSSMSFASFAAVEVQSTPEGQQKVGTISANAGTNLGSLEEQLAQKADEMGAKSFRITSVTGPNTLHGTAVIYK	BHSA_ECOLI	G
C6EGC7_ECOBD	MKLNIFTKSMIGMGLVCSALPALAMEAWNNQQGGNKYQVIFDGKIYENAWWVSSTNCPGKAKANDATNPWRLKRTATAAEISQFGNTLSCEKSGSSSSSNSNTPASNTPANSEPSTPADSGNDYSLQAWSGQEGSEIYHVIFNGNVYKNAWWVGSKDCPRGTSAENSNNPWRLERTATAAELSQYGNPTTCEIDNGGVIVADGFQASKAYSADSIVDYNDAHYKTSVDQDAW	CHIA_ECOLI	G
C6EHG9_ECOBD	MNALLLLAALSSQITFNTTQQGDVYTIIPEVTLTQSCLCRVQILSLREGSSGQSQTKQEKTLSLPANQPIALTRLSLNISPDDRVKIVVTVSDGQSLHLSQQWPPSSEKS	CSGC_ECOLI	G
C6EHH3_ECOBD	MKRYLRWIVAAEFLFAAGNLHAVEVEVPGLLTDHTVSSIGHDFYRAFSDKWESDYTGNLTINERPSARWGSWITITVNQDVIFQTFLFPLKRDFEKTVVFALIQTEEALNRRQINQALLSTGDLAHDEF	CSGE_ECOLI	G
C6EHH4_ECOBD	MRVKHAVVLLMLISPLSWAGTMTFQFRNPNFGGNPNNGAFLLNSAQAQNSYKDPSYNDDFGIETPSALDNFTQAIQSQILGGLLSNINTGKPGRMVTNDYIVDIANRDGQLQLNVTDRKTGQTSTIQVSGLQNNSTDF	CSGF_ECOLI	G
C6EKC8_ECOBD	MKKALQVAMFSLFTVIGFNAQANEHHHETMSEAQPQVISATGEVKGIDLESKKITIHHDPIAAVNWPEMTMRFTITPQTKMSEIKTGDKVAFNFVQQGNLSLLQDIKVSQ	CUSF_ECOLI	G
C6EEN0_ECOBD	MKRSISFRPTLLALVLATNFPVAHAAVPKDMLVIGKAADPQTLDPAVTIDNNDWTVTYPSYQRLVQYKTDGDKGSTDVEGDLASSWKASDDQKEWTFTLKDNAKFADGTPVTAEAVKLSFERLLKIGQGPAEAFPKDLKIDAPDEHTVKFTLSQPFAPFLYTLANDGASIINPAVLKEHAADDARGFLAQNTAGSGPFMLKSWQKGQQLVLVPNPHYPGNKPNFKRVSVKII	DDPA_ECOLI	G
C6EAE4_ECOBD	MFFNTKHTTALCFVTCMAFSSSSIADIVISGTRVIYKSDQKSVNVRLENKGNNPLLVQSWLDTGDDNAEPGSITVPFTATPPVSRIDAKRGQTIKLMYTASTSLPKDRESVFWFNVLEVPPKPDAEKVANQSLLQLAFRTRIKLFYRPDGLKGNPSEAPLALKWFWSGSEGKASLRVTNPTPYYVSFSSGDLEASGKRYPIDVKMIAPFSDEVMKVTGLNGKASSAKVHFYA	ECPD_ECOLI	G
C6ELA0_ECOBD	MEQINSNKKHSNRRKYFSLLAVVLFIAFSGAYAYWSMELEDMISTDDAYVTGNADPISAQVSGSVTVVNHKDTNYVRQGDILVSLDKTDATIALNKAKNNLANIVRQTNKLYLQDKQYSAEVASARIQYQQSLEDYNRRVPLAKQGVISKETLEHTKDTLISSKAALNAAIQAYKANKALVMNTPLNRQPQVVEAADATKEAWLALKRTDIKSPVTGYIAQRSVQVGETVSP	EMRK_ECOLI	G
C6EIG6_ECOBD	MYRYLSIAAVVLSAAFSGPALAEGINSFSQAKAAAVKVHADAPGTFYCGCKINWQGKKGVVDLQSCGYQVRKNENRASRVEWEHVVPAWQFGHQRQCWQDGGRKNCAKDPVYRKMESDMHNLQPSVGEVNGDRGNFMYSQWNGGEGQYGQCAMKVDFKEKAAEPPARARGAIARTYFYMRDQYNLTLSRQQTQLFNAWNKMYPVTDWKCERDERIAKVQGNHNPYVQRACQA	END1_ECOLI	G
C6EBR7_ECOBD	MSNKNVNVRKSQEITFCLLAGILMFMAMMVAGRAEAGVALGATRVIYPAGQKQVQLAVTNNDENSTYLIQSWVENADGVKDGRFIVTPPLFAMKGKKENTLRILDATNNQLPQDRESLFWMNVKAIPSMDKSKLTENTLQLAIISRIKLYYRPAKLALPPDQAAEKLRFRRSANSLTLINPTPYYLTVTELNAGTRVLENALVPPMGESTVKLPSDAGSNITYRTINDYGAL	FIMC_ECOLI	G
C6EBR8_ECOBD	MKRKRLFLLASLLPMFALAGNKWNTTLPGGNMQFQGVIIAETCRIEAGDKQMTVNMGQISSNRFHAVGEDSAPVPFVIHLRECSTVVSERVGVAFHGVADGKNPDVLSVGEGPGIATNIGVALFDDEGNLVPINRPPANWKRLYSGSTSLHFIAKYRATGRRVTGGIANAQAWFSLTYQ	FIMI_ECOLI	G
C6EHE1_ECOBD	MLIIKRSVAIIAILFSPLSTASNLTSQLHNFFSAQLAGVSDEVRVSIRTAPNLLPPCEQPLLSMSNNSRLWGNVNVLARCGNDKRYLQVNVQATGNYVVAAMPIARGGKLEAGNVKLKRGRLDTLPPRTVLDINQLVDAISLRDLSPDQPIQLTQFRQAWRVKAGQRVNVIASGDGFSANAEGQALNNAAVAQNARVRMVSGQVVSGVVDADGNILINL	FLGA_ECOLI	G
C6EHE0_ECOBD	MLDKLDAALRFQQEALNLRAQRQEVLAANIANADTPGYQARDIDFASELKKVIQRGRDATSVVALTMTSTQHIPAQALTPPTAELQYRIPDQPSLDGNTVDMDRERTQFADNSLQYQMSLSALSGQIKGMMNVLQSGN	FLGB_ECOLI	G
C6EHD9_ECOBD	MALLNIFDIAGSALTAQSQRLNVAASNLANADSVTGPDGQPYRAKQVVFQVNAAPGAATGGVKVADVIESQAPDKLVYEPGNPLADAKGYVKMPNVDVVGEMVNTMSASRSYQANVEVLNTVKSMMLKTLTLGQ	FLGC_ECOLI	G
C6EHD6_ECOBD	MDHAIYTAMGAASQTLNQQAVTASNLANASTPGFRAQLNALRAVPVEGLSLPTRTLVTASTPGADMTPGKMDYTSRPLDVALQQDGWLAVQTADGSEGYTRNGSIQVDPTGQLTIQGHPVIGEAGPIAVPEGAEITIAADGTISALNPGDPANTVAPVGRLKLVKATGSEVQRGDDGIFRLSAETQATRGPVLQADPTLRVMSGVLEGSNVNAVAAMSDMIASARRFEMQMK	FLGF_ECOLI	G
C6EHD5_ECOBD	MISSLWIAKTGLDAQQTNMDVIANNLANVSTNGFKRQRAVFEDLLYQTIRQPGAQSSEQTTLPSGLQIGTGVRPVATERLHSQGNLSQTNNSKDVAIKGQGFFQVMLPDGSSAYTRDGSFQVDQNGQLVTAGGFQVQPAITIPANALSITIGRDGVVSVTQQGQAAPVQVGQLNLTTFMNDTGLESIGENLYTETQSSGAPNESTPGLNGAGLLYQGYVETSNVNVAEELVN	FLGG_ECOLI	G
C6EHD3_ECOBD	MIKFLSALILLLVTTAAQAERIRDLTSVQGVRQNSLIGYGLVVGLDGTGDQTTQTPFTTQTLNNMLSQLGITVPTGTNMQLKNVAAVMVTASLPPFGRQGQTIDVVVSSMGNAKSLRGGTLLMTPLKGVDSQVYALAQGNILVGGAGASAGGSSVQVNQLNGGRITNGAVIERELPSQFGVGNTLNLQLNDEDFSMAQQIADTINRVRGYGSATALDARTIQVRVPSGNSSQ	FLGI_ECOLI	G
C6EBU9_ECOBD	MRTLLAILLFPLLVQAAGEGMWQASSVGITLNHRGESMSSAPLSTRQPASGLMTLVAWRYQLIGPTPSGLRVRLCSQSRCVELEGQSGTTVAFSGIAAAEPLRFIWEVPGGGRLIPPLKVQRNEVIVNYR	FLHE_ECOLI	G
C6EHM2_ECOBD	MNKLQSYFIASVLYVMTPHAFAQGTVTIYLPGEEQTLSVGPVENVVQLVTQPQLRDRLWWPVALLTDSAAKAKALKDYQHVMAQLASWEAEADDDVAATIKSVRQQLLNLNITGRLPVKLDPDFVRVDENSNPPLVGDYTLYTVQRPVTITLLGAVSGAGQLPWQAGRSVTDYLQDHPRLAGADKNNVMVITPEGETVVAPVALWNKRHVEPPPGSQLWLGFSAHVLPEKYA	GFCC_ECOLI	G
C6EHM3_ECOBD	MKKNSYLLSCLAIAVSSACHAEVLTYPDPLGSSQSDFGGTGLLQMPNARIAPEGEFSVNYRDNDQYRFYSTSVALFPWLEGTIRYTDVRTRKYSQWEDFSGDQSYKDKSFDFKLRLWEEGYWLPQVAFGKRDIAGTGLFDGEYLVASKQAGPFDFTLGMAWGYAGNAGNITNPFCRVSDKYCHRAESHDAGDISFSDIFRGPASIFGGIEYQTPWNPLRLKLEYDGNNYQND	GFCD_ECOLI	G
C6EFC7_ECOBD	MIKPTFLRRVAIAALLSGSCFSAAAAPPAPPVSYGVEEDVFHPVRAKQGMVASVDATATQVGVDILKEGGNAVDAAVAVGYALAVTHPQAGNLGGGGFMLIRSKNGNTTAIDFREMAPAKATRDMFLDDQGNPDSKKSLTSHLASGTPGTVAGFSLALDKYGTMPLNKVVQPAFKLARDGFIVNDALADDLKTYGSEVLPNHENSKAIFWKEGEPLKKGDTLVQANLAKSLE	GGT_ECOLI	G
C6EGE1_ECOBD	MKGLNKITCCLLAALLMPCAGHAENEQYGANFNNADIRQFVEIVGQHLGKTILIDPSVQGTISVRSNDTFSQQEYYQFFLSILDLYGYSVITLDNGFLKVVRSANVKTSPGMIADSSRPGVGDELVTRIVPLENVPARDLAPLLRQMMDAGSVGNVVHYEPSNVLILTGRASTINKLIEVIKRVDVIGTEKQQIIHLEVSSVDSSSNSTLGPTFNTRTIQNAVLVKTGETVV	GSPD_ECOLI	G
C6EGD7_ECOBD	MNQQRGFILLEMMLVLALVAITASVVLFTYGREDVANTRARETAARFTAALELAIDRATLSGQPVGIHFSDSAWRIMVPGKTPSAWRWVPLQEDAADESQNDWDEELSIHLQPFKPDDSNQPQVVILADGQITPFSLLMANAGTGEPLLTLVCSGSWPLDQTLARDTRP	GSPH_ECOLI	G
C6EGD6_ECOBD	MNKQSGMTLLEVLLAMSIFTAVALTLMSSMQGQRNAIERMRNETLALWIADNQLQSQDSFGEENTSSSGKELINGEEWNWRSDIHSSKDGTLLERTITVTLPSGQTTSLTRYQSIDNKSGQAQDD	GSPI_ECOLI	G
C6EGD5_ECOBD	MINRQQGFTLLEVMAALAIFSMLSVLAFMIFSQASELHQRSQKEIQQFNQLQRTITILDNDLLQLVARRNRSTDKIMVLGEEAIFTTQSRDPLAPLSEAQTLLTVHWYLRNHTLYRAVRTSVDGRKDQPAQAMLEHVESFLLESNSGESQELPLSVTLHLQTQQYGGLQRRFALPEQLAREESPAQTQAGNNNHE	GSPJ_ECOLI	G
C6EGD4_ECOBD	MNNEQRGVALLIVLMLLALMAALAADMTLSFHSQLQRTRQVNHHLQRQYDIELAEKLALASLTQDVKDNDRQTTLQQYWAQPQQLQLEDGNTVKWQLRDAQHCFNLNALAKISDDPLASPDFPAQVFSALLINAGIDRGNTDEIVQSIADYIDVDDSPRFHGAEDNFYQSQTPPRHSANQMLFLTGELRQIKGITENIYQRLIPYVCVLPTTELSINLNMLTENDIPIFRAL	GSPK_ECOLI	G
C6EEH5_ECOBD	MKKVLGVILGGLLLLPVVSNAADAQKAADNKKPVNSWTCEDFLAVDESFQPTAVGFAEALNNKDKPEDAVLDVQGIATVTPAIVQACTQDKQANFKDKVKGEWDKIKKDM	HDEA_ECOLI	G
C6EEH6_ECOBD	MGYKMNISSLRKAFIFMGAVAALSLVNAQSALAANESAKDMTCQEFIDLNPKAMTPVAWWMLHEETVYKGGDTVTLNETDLTQIPKVIEYCKKNPQKNLYTFKNQASNDLPN	HDEB_ECOLI	G
C6EB98_ECOBD	MLKRYLVLSVATAAFSLPSLVNAAQQNILSVHILNQQTGKPAADVTVTLEKKADNGWLQLNTAKTDKDGRIKALWPEQTATTGDYRVVFKTGDYFKKQNLESFFPEIPVEFHINKVNEHYHVPLLLSQYGYSTYRGS	HIUH_ECOLI	G
C6EA68_ECOBD	MGRISSGGMMFKAITTVAALVIATSAMAQDDLTISSLAKGETTKAAFNQMVQGHKLPAWVMKGGTYTPAQTVTLGDETYQVMSACKPHDCGSQRIAVMWSEKSNQMTGLFSTIDEKTSQEKLTWLNVNDALSIDGKTVLFAALTGSLENHPDGFNFK	IVY_ECOLI	G
C6EFB6_ECOBD	MKRNAKTIIAGMIALAISHTAMADDIKVAVVGAMSGPIAQWGDMEFNGARQAIKDINAKGGIKGDKLVGVEYDDACDPKQAVAVANKIVNDGIKYVIGHLCSSSTQPASDIYEDEGILMISPGATNPELTQRGYQHIMRTAGLDSSQGPTAAKYILETVKPQRIAIIHDKQQYGEGLARSVQDGLKAANANVVFFDGITAGEKDFSALIARLKKENIDFVYYGGYYPEMGQM	LIVK_ECOLI	G
C6EEK7_ECOBD	MTLHRFKKIALLSVLGIAAISMNVQAAERIAFIPKLVGVGFFTSGGNGAQQAGKELGVDVTYDGPTEPSVSGQVQLINNFVNQGYNAIIVSAVSPDGLCPALKRAMQRGVRVLTWDSDTKPECRSYYINQGTPAQLGGMLVDMAARQVNKDKAKVAFFYSSPTVTDQNQWVKEAKAKIAKEHPGWEIVTTQFGYNDATKSLQTAEGILKAYSDLDAIIAPDANALPAAAQAA	LSRB_ECOLI	G
C6EDY5_ECOBD	MKMNKSLIVLCLSAGLLASAPGISLADVNYVPQNTSDAPAIPSAALQQLTWTPVDQSKTQTTQLATGGQQLNVPGISGPVAAYSVPANIGELTLTLTSEVNKQTSVFAPNVLILDQNMTPSAFFPSSYFTYQEPGVMSADRLEGVMRLTPALGQQKLYVLVFTTEKDLQQTTQLLDPAKAYAKGVGNSIPDIPDPVARHTTDGLLKLKVKTNSSSSVLVGPLFGSSAPAPVT	MALM_ECOLI	G
C6EDV5_ECOBD	MKPLSSAIAAALILFSAQGVAEQTTQPVVTSCANVVVVPPSQEHPPFDLNHMGTGSDKSDALGVPYYNQHAM	MARB_ECOLI	G
C6ELT7_ECOBD	MTHWDITSSIQLGKKCNEKKVLAIALVTVFTGMGVAQAADVTAQAVATWSATAKKDTTSKLVVTPLGSLAFQYAEGIKGFNSQKGLFDVAIEGDSTATAFKLTSRLITNTLTQLDTSGSTLNVGVDYNGAAVEKTGDTVMIDTANGVLGGNLSPLANGYNASNRTTAQDGFTFSIISGTTNGTTAVTDYSTLPEGIWSGDVSVQFDATWTS	MATB_ECOLI	G
C6ELT8_ECOBD	MKKHLLPLALLFSGISPAQALDVGDISSFMNSDSSTLSKTIKNSTDSGRLINIRLERLSSPLDDGQVIAMDKPDELLLTPASLLLPAQASEVIRFFYKGPADEKERYYRIVWFDQALSDAQRDNANRSAVATASARIGTILVVAPRQANYHFQYANGSLTNTGNATLRILAYGPCLKAANGKECKENYYLMPGKSRRFTRVDTADNKGRVALWQGDKFIPVK	MATC_ECOLI	G
C6EIX6_ECOBD	MKKCLTLLIATVLSGISLTAYAAQPMSNLDSGQLRPAGTVSATGASNLSDLEDKLAEKAREQGAKGYVINSAGGNDQMFGTATIYK	MCBA_ECOLI	G
C6EC04_ECOBD	MKKFRWVVLVVVVLACLLLWAQVFNMMCDQDVQFFSGICAINQFIPW	MGRB_ECOLI	G
C6EBS4_ECOBD	MKKAKILSGVLLLCFSSPLISQAATLDVRGGYRSGSHAYETRLKVSEGWQNGWWASMESNTWNTIHDNKKENAALNDVQVEVNYAIKLDDQWTVRPGMLTHFSSNGTRYGPYVKLSWDATKDLNFGIRYRYDWKAYRQQDLSGDMSRDNVHRWDGYVTYHINSDFTFAWQTTLYSKQNDYRYANHKKWATENAFVLQYHMTPDITPYIEYDYLDRQGVYNGRDNLSENSYRI	NANC_ECOLI	G
C6EBS5_ECOBD	MNKTITALAIMMASFAANASVLPETPVPFKSGTGAIDNDTVYIGLGSAGTAWYKLDTQAKDKKWTALAAFPGGPRDQATSAFIDGNLYVFGGIGKNSEGLTQVFNDVHKYNPKTNSWVKLMSHAPMGMAGHVTFVHNGKAYVTGGVNQNIFNGYFEDLNEAGKDSTAIDKINAHYFDKKAEDYFFNKFLLSFDPSTQQWSYAGESPWYGTAGAAVVNKGDKTWLINGEAKPG	NANM_ECOLI	G
C6E9Z7_ECOBD	MKSHDLKKALCQWTAMLALVVSGAVWAANGVDFSQSPEVSGTQEGAIRMPKEQERMPLNYVNQPPMIPHSVEGYQVTTNTNRCLQCHGVESYRTTGAPRISPTHFMDSDGKVGAEVAPRRYFCLQCHVPQADTAPIVGNTFTPSKGYGK	NAPB_ECOLI	G
C6E9Z5_ECOBD	MSRSAKPQNGRRRFLRDVVRTAGGLAAVGVALGLQQQTARASGVRLRPPGAINENAFASACVRCGQCVQACPYDTLKLATLASGLSAGTPYFVARDIPCEMCEDIPCAKVCPSGALDREIESIDDARMGLAVLVDQENCLNFQGLRCDVCYRECPKIDEAITLELERNTRTGKHARFLPTVHSDACTGCGKCEKVCVLEQPAIKVLPLSLAKGELGHHYRFGWLEGNNGKS	NAPG_ECOLI	G
C6EF98_ECOBD	MLSTLRRTLFALLACASFIVHAAAPDEITTAWPVNVGPLNPHLYTPNQMFAQSMVYEPLVKYQADGSVIPWLAKSWTHSEDGKTWTFTLRDDVKFSNGEPFDAEAAAENFRAVLDNRQRHAWLELANQIVDVKALSKTELQITLKSAYYPFLQELALPRPFRFIAPSQFKNHETMNGIKAPIGTGPWILQASKLNQYDVFVRNENYWGEKPAIKKITFNVIPDPTTRAVAFE	NIKA_ECOLI	G
C6ED55_ECOBD	MTRIKINARRIFSLLIPFFFFTSVHAEQTAAPAKPVTVEAKNETFAPQHPDQYLSWKATSEQSERVDALAEDPRLVILWAGYPFSRDYNKPRGHAFAVTDVRETLRTGAPKNAEDGPLPMACWSCKSPDVARLIQKDGEDGYFHGKWARGGPEIVNNLGCADCHNTASPEFAKGKPELTLSRPYAARAMEAIGKPFEKAGRFDQQSMVCGQCHVEYYFDGKNKAVKFPWDDG	NRFA_ECOLI	G
C6ED54_ECOBD	MSVLRSLLTAGVLASGLLWSLNGITATPAAQASDDRYEVTQQRNPDAACLDCHKPDTEGMHGKHASVINPNNKLPVTCTNCHGQPSPQHREGVKDVMRFNEPMYKVGEQNSVCMSCHLPEQLQKAFWPHDVHVTKVACASCHSLHPQQDTMQTLSDKGRIKICVDCHSDQRTNPNFNPASVPLLKEQP	NRFB_ECOLI	G
C6ED53_ECOBD	MTWSRRQFLTGVGVLAAVSGTAGRVVAKTLNINGVRYGMVHDESLCIGCTACMDACREVNKVPEGVSRLTIIRSEPQGEFPDVKYRFFRKSCQHCDHAPCVDVCPTGASFRDAASGIVDVNPDLCVGCQYCIAACPYRVRFIHPVTKTADKCDFCRKTNLQAGKLPACVEACPTKALTFGNLDDPNSEISQLLRQKPTYRYKLALGTKPKLYRVPFKYGEVSQ	NRFC_ECOLI	G
C6EHS3_ECOBD	MKALNREVIEYFKEHVNPGFLEYRKSVTAGGDYGAVEWQAGSLNTLVDTQGQEFIDCLGGFGIFNVGHRNPVVVSAVQNQLAKQPLHSQELLDPLRAMLAKTLAALTPGKLKYSFFCNSGTESVEAALKLAKAYQSPRGKFTFIATSGAFHGKSLGALSATAKSTFRKPFMPLLPGFRHVPFGNIEAMRTALNECKKTGDDVAAVILEPIQGEGGVILPPPGYLTAVRKLCD	PAT_ECOLI	G
C6EAH7_ECOBD	MLIMPKFRVSLFSLALMLAVPFAPQAVAKTAAATTASQPEIASGSAMIVDLNTNKVIYSNHPDLVRPIASISKLMTAMVVLDARLPLDEKLKVDISQTPEMKGVYSRVRLNSEISRKDMLLLALMSSENRAAASLAHHYPGGYKAFIKAMNAKAKSLGMNNTRFVEPTGLSVHNVSTARDLTKLLIASKQYPLIGQLSTTREDMATFSNPTYTLPFRNTNHLVYRDNWNIQL	PBP7_ECOLI	G
C6ED19_ECOBD	MNAKIIASLAFTSMFSLSTLLSPAHAEEQEKALNFGIISTESQQNLKPQWTPFLQDMEKKLGVKVNAFFAPDYAGIIQGMRFNKVDIAWYGNLSAMEAVDRANGQVFAQTVAADGSPGYWSVLIVNKDSPINNLNDLLAKRKDLTFGNGDPNSTSGFLVPGYYVFAKNNISASDFKRTVNAGHETNALAVANKQVDVATNNTENLDKLKTSAPEKLKELKVIWKSPLIPGDP	PHND_ECOLI	G
C6ED31_ECOBD	MSLTLTLTGTGGAQGVPAWGCECAACARARRSPQYRRQPCSGVVKFNDAITLIDAGLHDLADRWSPGSFQQFLLTHYHMDHVQGLFPLRWGVGDPIPVYGPPDEQGCDDLFKHPGLLDFSHTVEPFVVFDLQGLQVTPLPLNHSKLTFGYLLETAHSRVAWLSDTAGLPEKTLKFLRNNQPQVMVMDCSHPPRADAPRNHCDLNTVLALNQVIRSPRVILTHISHQFDAWLM	PHNP_ECOLI	G
C6EIC7_ECOBD	MTALNKKWLSGLVAGALMAVSVGTLAAEQKTLHIYNWSDYIAPDTVANFEKETGIKVVYDVFDSNEVLEGKLMAGSTGFDLVVPSASFLERQLTAGVFQPLDKSKLPEWKNLDPELLKLVAKHDPDNKFAMPYMWATTGIGYNVDKVKAVLGENAPVDSWDLILKPENLEKLKSCGVSFLDAPEEVFATVLNYLGKDPNSTKADDYTGPATDLLLKLRPNIRYFHSSQYIND	POTF_ECOLI	G
C6EHM7_ECOBD	MKAILIPFLSLLIPLTPQSAFAQSEPELKLESVVIVSRHGVRAPTKATQLMQDVTPDAWPTWPVKLGWLTPRGGELIAYLGHYQRQRLVADGLLAKKGCPQSGQVAIIADVDERTRKTGEAFAAGLAPDCAITVHTQADTSSPDPLFNPLKTGVCQLDNANVTDAILSRAGGSIADFTGHRQTAFRELERVLNFPQSNLCLKREKQDESCSLTQALPSELKVSADNVSLTGA	PPA_ECOLI	G
C6EJ43_ECOBD	MKTQRGYTLIETLVAMLILVMLSASGLYGWQYWQQSQRLWQTASQARDYLLYLREDANWHNRDHSISVIREGTLWCLVSSVAGANTCHGSSPLVFVPRWPEVEMSDLTPSLAFFGLRNTAWAGHIRFKNSTGEWWLVVSPWGRLRLCQQGETEGCL	PPDA_ECOLI	G
C6ELK3_ECOBD	MKITLLVTLLFGLVFLTTVGAAERTLTPQQQHMTSCNQQATAQALKGDARKTYMSDCLKNSKSAPGEKSLTPQQQKMRECNNQATQQSLKGDDRNKFMSACLKKAA	PSIF_ECOLI	G
C6EL81_ECOBD	MSKKLIALCACPMGLAHTFMAAQALEEAAVEAGYEVKIETQGADGIQNRLTAQDIAEATIIIHSVAVTPEDNERFESRDVYEITLQDAIKNAAGIIKEIEEMIASEQQ	PTFB1_ECOLI	G
C6EHJ7_ECOBD	MPKSVIIPAGSSAPLAPFVPGTLADGVVYVSGTLAFDQHNNVLFADDPKAQTRHVLETIRKVIETAGGTMADVTFNSIFITDWKNYAAINEIYAEFFPGDKPARFCIQCGLVKPDALVEIATIAHIAK	RUTC_ECOLI	G
C6EAV8_ECOBD	MLWTAGFNDKICALNTFEYDRDGNNVSGILTRWRQFGKRYFWPHLLLGMVAASLGLPALSNAAEPNAPAKATTRNHEPSAKVNFGQLALLEANTRRPNSNYSVDYWHQHAIRTVIRHLSFAMAPQTLPVAEESLPLQAQHLALLDTLSALLTQEGTPSEKGYRIDYAHFTPQAKFSTPVWISQAQGIRAGPQRLT	SECM_ECOLI	G
C6EKT6_ECOBD	MKLRFISSALAAALFAATGSYAAVVDGGTIHFEGELVNAACSVNTDSADQVVTLGQYRTDIFNAVGNTSALIPFTIQLNDCDPVVAANAAVAFSGQADAINDNLLAIASSTNTTTATGVGIEILDNTSAILKPDGNSFSTNQNLIPGTNVLHFSARYKGTGTSASAGQANADATFIMRYE	SFMA_ECOLI	G
C6EKT5_ECOBD	MMTKIKLLMLIIFYLIISASAHAAGGIALGATRIIYPADAKQTAVWIRNSHTNERFLVNSWIENSSGVKEKSFIITPPLFVSEPKSENTLRIIYTGPPLAADRESLFWMNVKTIPSVDKNALNGRNVLQLAILSRMKLFLRPIQLQELPAEAPDTLKFSRSGNYINVHNPSPFYVTLVNLQVGSQKLGNAMAAPRVNSQIPLPSGVQGKLKFQTVNDYGSVTPVREVNLN	SFMC_ECOLI	G
C6EKT2_ECOBD	MRRVLFSCFCGLLWSSSGWAADPLGTININLHGNVVDFSCTVNTADIDKTVDLGRWPTTQLLNAGDTTALVPFSLRLEGCPPGSVAILFTGTPASDTNLLALDDPAMAQTVAIELRNSDRSRLALGEASPTEEVDANGNVTLNFFANYRALASGVRPGVAKADAIFMINYN	SFMF_ECOLI	G
C6EKT3_ECOBD	MACLCLANISWATVCANSTGVAEDEHYDLSNIFNSTNNQPGQIVVLPEKSGWVGVSAICPPGTLVNYTYRSYVTNFIVQETIDNYKYMQLHDYLLGAMSLVDSVMDIQFPPQNYIRMGTDPNVSQNLPFGVMDSRLIFRLKVIRPFINMVEIPRQVMFTVYVTSTPYDPLVTPVYTISFGGRVEVPQNCELNAGQIVEFDFGDIGASLFSAAGPGNRPAGVMPQTKSIAVKC	SFMH_ECOLI	G
C6EEY1_ECOBD	MNKWGVGLTFLLAATSVMAKDIQLLNVSYDPTRELYEQYNKAFSAHWKQQTGDNVVIRQSHGGSGKQATSVINGIEADVVTLALAYDVDAIAERGRIDKEWIKRLPDNSAPYTSTIVFLVRKGNPKQIHDWNDLIKPGVSVITPNPKSSGGARWNYLAAWGYALHHNNNDQAKAQDFVRALYKNVEVLDSGARGSTNTFVERGIGDVLIAWENEALLAANELGKDKFEIVTP	SUBI_ECOLI	G
C6ELL9_ECOBD	MAISSRNTLLAALAFIAFQAQAVNVTVAYQTSAEPAKVAQADNTFAKESGATVDWRKFDSGASIVRALASGDVQIGNLGSSPLAVAASQQVPIEVFLLASKLGNSEALVVKKTISKPEDLIGKRIAVPFISTTHYSLLAALKHWGIKPGQVEIVNLQPPAIIAAWQRGDIDGAYVWAPAVNALEKDGKVLTDSEQVGQWGAPTLDVWVVRKDFAEKHPEVVKAFAKSAIDAQ	TAUA_ECOLI	G
C6EHL3_ECOBD	MRVLLFLLLSLFMLPAFSADNLLRWHDAQHFTVQASTPLKAKRAWKLCALYPSLKDSYWLSLNYGMQEAARRYGVDLKVLEAGGYSQLATQQAQIDQCKQWGAEAILLGSSTTSFPDLQKQVASLPVIELVNAIDAPQVKSRVGVPWFQMGYQPGRYLVQWAHGKPLNVLLMPGPDNAGGSKEMVEGFRAAIAGSPVRIVDIALGDNDIEIQRNLLQEMLERHPEIDVVAGT	TORT_ECOLI	G
C6EBV5_ECOBD	MTLTRREFIKHSGIAAGALVVTSAAPLPAWAEEKGGKILTAGRWGAMNVEVKDGKIVSSTGALAKTIPNSLQSTAADQVHTTARIQHPMVRKSYLDNPLQPAKGRGEDTYVQVSWEQALKLIHEQHDRIRKANGPSAIFAGSYGWRSSGVLHKAQTLLQRYMNLAGGYSGHSGDYSTGAAQVIMPHVVGSVEVYEQQTSWPLILENSQVVVLWGMNPLNTLKIAWSSTDEQG	TORZ_ECOLI	G
C6EAR4_ECOBD	MPFKKLSRRTFLTASSALAFLHTPFARALPARQIVNINDYNPHDWIASFKQAFSEGQTVVVPAGFVCENINTGIFIPPGKTLHILGSLRGNGRGRFVLQDGSQVTGEKGGRMHNITLDVRGSDCIIKGLAMSGFGPVTQIYIGGKNKRVMRNLTIDNLTVSHANYAILRQGFHNQIIGANITNCKFSDLQGDAIEWNVAINDRDILISDHVIERINCTNGKINWGIGIGLAG	WCAM_ECOLI	G
C6EEB2_ECOBD	MKIKNILLTLCTSLLLTNVAAHAKEVKIGMAIDDLRLERWQKDRDIFVKKAESLGAKVFVQSANGNEETQMSQIENMINRGVDVLVIIPYNGQVLSNVVKEAKQEGIKVLAYDRMINDADIDFYISFDNEKVGELQAKALVDIVPQGNYFLMGGSPVDNNAKLFRAGQMKVLKPYVDSGKIKVVGDQWVDGWLPENALKIMENALTANNNKIDAVVASNDATAGGAIQALSA	XYLF_ECOLI	G
C6EB41_ECOBD	MKSVFTISASLAISLMLCCTAQANDHKLLGVIAMPRNETNDLALKLPVCRIVKRIQLSADHGDLQLSGASVYFKAARSASQSLNIPSEIKEGQTTDWININSDNDNKRCVSKITFSGHTVNSSDMATLKIIGDD	YAAI_ECOLI	G
C6EAU0_ECOBD	MKMTLPFKPHVLALICSAGLCAASTGLYIKSRTVEAPVEPQSTQLAVSDAAAVTFPATVSAPPVTPAVVKSAFSTAQIDQWVAPVALYPDALLSQVLMASTYPTNVAQAVQWSHDNPLKQGDAAIQAVSDQPWDASVKSLVAFPQLMALMGENPQWVQNLGDAFLAQPQDVMDSVQRLRQLAQQTGSLKSSTEQKVITTTKKAVPVKQTVTAPVIPSNTVLTANPVITEPAT	YACH_ECOLI	G
C6EAS2_ECOBD	MKKFFRHFLFLILCLSCYTASAGTDDNVGYIVGNSYGVGPSDQKWRETGPNGDATVIFRYATSTNNLVFYKPTQLGPTGVKLQWSQLDTASGGGFLYCNRSDSTSGSAMRIENAMVDSGKMYGSHKLFNTSVPGLYYTLLISNMWSAYGTVTNVSSPGIYIGDSAEQYFSWYNPSEDVLYWSCNNANSTRKYWAVGGIYQTLTIEFYTDTNFDPTVTQQIKLSSSSNYLYSF	YADC_ECOLI	G
C6EAS1_ECOBD	MHPTQRKLMKRIILFLSLQFPITYPAIAGQDIDLVANVKNSTCKSGISNQGNIDLGVVGVGYFSDNVTPESYQPGGKEFTVTVSDCALQGTGDVLNQLHIDFRALSGVMAAGSRQIFANEVATGAKNVGVVLFSIQDPTNIFNVISSAGNSRSVYPVMTSALHNSSWKFYARMQKIDPALDVISGQVMSHILVDVYYE	YADK_ECOLI	G
C6EAS0_ECOBD	MTFKNLRYGLSSSVVLAASLFSVPSYAATDSIGLTVITTVEIGTCTATLVNDSDQDISVVDFGDVYISEINAKTKVKTFKLKFKDCAGIPNKKAQIKLTKRATCEGTANDGAGFANGSTAADKASAVAVEVWSTETPATGSATQFSCVTPASQEVTISNAANAVVYYPMSARLVVEKNKTVSNVTAGKFSAPATFTVTYN	YADL_ECOLI	G
C6EAE6_ECOBD	MIKITPHKIAILMGILLSPSVFATDINVEFTATVKATTCNITLTGNNVTNDGNNNYTLRIPKMGLDKIANKTTESQADFKLVASGCSSGISWIDTTLTGNASSSSPKLIIPQSGDSSSTTSNIGMGFKKRTTDDATFLKPNSAEKIRWSTDEMQPDKGLEMTVALRETDAGQGVPGNFRALATFNFIYQ	YADM_ECOLI	G
C6EAE3_ECOBD	MSKKLGFALSGLMLAMVAGTASADMDGGQLNISGLVVDNTCETRVDGGNKDGLILLQTATVGETDAGVLNDTVGAKAKPFSITVDCSKANPNPGSTAKMTFGSVFFGNSKGTLNNDMSINNPSDGVNIALHNIDGSTIKQVQINNPGDVYTKALDATTKSAVYDFKASYVRAVADQTATAGYVKTNTAYTITYQ	YADN_ECOLI	G
C6EA64_ECOBD	MRKIALILAMLLIPCVSFAGLLGSSSSTTPVSKEYKQQLMGSPVYIQIFKEERTLDLYVKMGEQYQLLDSYKICKYSGGLGPKQRQGDFKSPEGFYSVQRNQLKPDSRYYKAINIGFPNAYDRAHGYEGKYLMIHGDCVSIGCYAMTNQGIDEIFQFVTGALVFGQPSVQVSIYPFRMTDANMKRHKYSNFKDFWEQLKPGYDYFEQTRKPPTVSVVNGRYVVSKPLSHEVV	YAFK_ECOLI	G
C6EA60_ECOBD	MQNRARLLKQYQTHLKKQASYIVEGNAESRRALRQHNREQIKQHPEWFPAPLKASDRRWQALVENNHFLSSDHLHNITEVAIHRLEQQLGKPYVWGGTRPDQGFDCSGLVFYAYNKILEAKLPRTANEMYHYRRATIVANNDLRRGDLLFFHIHSREIADHMGVYLGDGQFIESPRTGETIRVSRLAEPFWQDHFLGARRILTEETIL	YAFL_ECOLI	G
C6EA39_ECOBD	MKFDKPAGENPIDQLKVVGRPYDRIDGPLKTTGTARYAYEWHEESPNAAYGYIVGSAMAKGRLTALDTDAAQKAPGVLAVITASNAGALGKGDKNTARLLGGPTIEHYHQAIALVVAETFEQARAAASLVQAHYRRNKGAYSLADEKQAVSQPPEDTPDKNVGDFDGAFTSAAVKIDATYTTPDQSHMAMEPHASMAVWDGNKLTLWTSNQMIDWCRTDLAKTLKVPVENVR	YAGR_ECOLI	G
C6EA38_ECOBD	MKAFTYERVNTPAEAALSAQRVPGAKFIAGGTNLLDLMKLEIETPTHLIDVNGLGLDKIEVTDAGGLRIGALVRNTDLAAHERVRRDYAVLSRALLAGASGQLRNQATTAGNLLQRTRCPYFYDTNQPCNKRLPGSGCAALEGFSRQHAVVGVSEACIATHPSDMAVAMRLLDAVVETITPEGKTRSITLADFYHPPGKTPHIETALLPGELIIAVTLPPPLGGKHIYRKVR	YAGS_ECOLI	G
C6EA37_ECOBD	MSNQGEYPEDNRVGKHEPHDFSLTRRDLIKVSAATAATAVVYPHSTLAASVPAATPAPEIMPLTLKVNGKTEQLEVDTRTTLLDALRENLHLIGTKKGCDHGQCGACTVLVNGRRLNACLTLAVMHQGAEITTIEGLGSPDNLHPMQAAFIKHDGFQCGYCTSGQICSSVAVLKEIQDGIPSHVTVDLVSAPETTADEIRERMSGNICRCGAYANILAAIEDAAGEIKS	YAGT_ECOLI	G
C6EA34_ECOBD	MFRRRGVTLTKALLTAVCMLAAPLTQAISVGNLTFSLPSETDFVSKRVVNNNKSARIYRIAISAIDSPGSSELRTRPVDGELLFAPRQLALQAGESEYFKFYYHGPQDNRERYYRVSFREVPTRNQTRRSPTGGEVSTEPVVVMDTILVVRPRQVQFKWSFDKVTGTVSNTGNTWFKLLIKPGCDSTEEEGDAWYLRPGDVVHQPELRQPGNHYLVYNDKFIKISDSCPAKP	YAGV_ECOLI	G
C6EA32_ECOBD	MPLRRFSPGLKAQFAFGMVFLFVQPDASAADISAQQIGGVIIPQAFSQALQDGMSVPLYIHLAGSQGRQDDQRIGSAFIWLDDGQLRIRKIQLEESEDNASVSEQTRQQLMALANAPFNEALTIPLTDNAQLDLSLRQLLLQLVVKREALGTVLRSRSEDIGQSSVNTLSSNLSYNFGIYNNQLRNGGSNTSSYLSLNNVTALREHHVVLDGSLYGIGSGQQDSELYKAMYE	YAGX_ECOLI	G
C6ELQ6_ECOBD	MKESNSRREFLSQSGKMVTAAALFGTSVPLAHAAVAGTLNCEANNTMKITDPHYYLDNVLLETGFDYENGVAVQTRTARQTVEIQDGKIVALRENKLHPDATLPHYDAGGKLMLPTTRDMHIHLDKTFYGGPWRSLNRPAGTTIQDMIKLEQKMLPELQPYTQERAEKLIDLLQSKGTTIARSHCNIEPVSGLKNLQNLQAVLARRQAGFECEIVAFPQHGLLLSKSEPLMR	YAHJ_ECOLI	G
C6ELQ1_ECOBD	MKIISKMLVGALALAVTNVYAAELMTKAEFEKVESQYEKIGDISTSNEMSTADAKEDLIKKADEKGADVLVLTSGQTDNKIHGTANIYKKK	YAHO_ECOLI	G
C6ELM2_ECOBD	MIKRTLLAAAIFSALPAYAGLTSITAGYDFTDYSGDHGNRNLAYAELVAKVENATLLFNLSQGRRDYETEHFNATRGQGAVWYKWNNWLTTRTGIAFADNTPVFARQDFRQDINLALLPKTLFTTGYRYTKYYDDVEVDAWQGGVSLYTGPVITSYRYTHYDSSDAGGSYSNMISVRLNDPRGTGYTQLWLSRGTGAYTYDWTPETRYGSMKSVSLQRIQPLTEQLNLGLTA	YAIO_ECOLI	G
C6EL21_ECOBD	MKHGIKALLITLSLACAGMSHSALAAAPAAKPTTVETKAEAPAAQSKAAVLAKASDEEGTRVSINNASAEELARAMNGVGLKKAQAIVSYREEYGPFKTVEDLKQVPGMGNSLVERNLAVLTL	YBAV_ECOLI	G
C6EJN3_ECOBD	MKRVLFFLLMIFVSFGVIADCEIQAKDHDCFTIFAKGTIFSAFPVLNNKAMWRWYQNEDIGEYYWQTELGTCKNNKFTPSGARLLIRVGSLRLNENHAIKGTLQELINTAEKTAFLGDRFRSYIRAGIYQKKSSDPAQLLAVLDNSIMVKYFKEEKPTYARMTAHLPNKDESYECLTKIQHELLRSEEK	YBFC_ECOLI	G
C6EJL9_ECOBD	MFKGQKTLTALAISLLFTAPVYAADEGSGEIHFKGEVIEAPCEIHQDDIDKEVELGQVTTSHINQSHHSDAVAVDLRLVNCDLENSSNGSGGKISKVAVTFDSSAKTTGADPILNNTSTGEATGVGVRLMNKDQSNIVLGTATPDIDLAPTSSEQTLNFFAWMEQIDQATPVTPGAVTANATYVLDYK	YBGD_ECOLI	G
C6EJM2_ECOBD	MSAGKGVLLVICLLFLPLKSALALNCYFGSSGGSVEKSEVIQPFAVPGNAKPGDKIWESDDIKIPVYCDNNTNGNFESEHVYAWVNPYPGVQDRYYQLGVTYNGVDYDANQGKSRIDTNQCIDSKNIDIYTPEQIIAMGWQNKICSGDPANIHMSRTFLARMRLYVKIREMPPHDYQSTLSDYIVVQFDGAGSVNEDPTAQNLKYHITGLENIRVLDCSVNFSISPETQMID	YBGO_ECOLI	G
C6EJJ1_ECOBD	MKMTKLATLFLTATLSLASGAALAADSGAQTNNGQANAAADAGQVAPDARENVAPNNVDNNGVNTGSGGTMLHSDGSSMNNDGMTKDEEHKNTMCKDGRCPDINKKVQTGDGINNDVDTKTDGTTQ	YBGS_ECOLI	G
C6EIY0_ECOBD	MKTINTVVAAMALSTLSFGVFAAEPVTASQAQNMNKIGVVSADGASTLDALEAKLAEKAAAAGASGYSITSATNNNKLSGTAVIYK	YBIJ_ECOLI	G
C6EIU0_ECOBD	MKNCLLLGALLMGFTGVAMAQSVTVDVPSGYKVVVVPDSVSVPQAVSVATVPQTVYVAPAPAPAYRPHPYVRHLASVGEGMVIEHQIDDHHH	YBJH_ECOLI	G
C6EI38_ECOBD	MTNTWNRLALLIFAVLSLLVAGELQAGVVVGGTRFIFPADRESISILLTNTSQESWLINSKINRPTRWAGGEASTVPAPLLAAPPLILLKPGTTGTLRLLRTESDILPVDRETLFELSIASVPSGKVENQSVKVAMRSVFKLFWRPEGLPGDPLEAYQQLRWTRNSQGVQLTNPTPYYINLIQVSVNGKALSNVGVVPPKSQRQTSWCQAIAPCHVAWRAINDYGGLSAKKE	YCBF_ECOLI	G
C6EI44_ECOBD	MKKSVLTAFITVVCATSSVMAADDNAITDGSVTFNGKVIAPACTLVAATKDSVVTLPDVSATKLQTNGQVSGVQIDVPIELKDCDTTVTKNATFTFNGTADTTQITAFANQASSDAATNVALQMYMNDGTTAITPDTETGNILLQDGDQTLTFKVDYIATGKATSGNVNAVTNFHINYY	YCBQ_ECOLI	G
C6EI43_ECOBD	MKTCITKGIVTVSLTAILLSCSSAWAAGKGGIGLAATRLVYSEGEEQISLGVRNTSPDVPYLIQSWVMTPDNKKSADFIITPPLFVLNPANENLLRIMYIGAPLAKDRETLFFTSVRAVPSTTKRKEGNTLKIATQSVIKLFWRPKGLAYPLGEAPAKLRCTSSADMVTVSNPTPYFITLTDLKIGGKVVKNQMISPFDKYQFSLPKGAKNSSVTYRTINDYGAETPQLNCK	YCBR_ECOLI	G
C6EI41_ECOBD	MQIIFGEKCVSLLRLFFAAVLMLWCAQTAAYSGQCHTTQGNPYIGVNFGVKTLEEEANTAGVVKDKFYQWNESNDYYVSCDCDKDNVRSGRWAFAADSPLVYLGDNWYKINDYLAAKVLLQVKGSSPTAVPFENVGTGGDTRWHICDPGGQRLGGQGASGNSGSFSLKILQPFVGSVVIPPMALARLYECYNIPAGDSCTTTGTPVLVYYLSGTINSLGSCSVNAGETIEVD	YCBT_ECOLI	G
C6EI40_ECOBD	MKKKTIFQCVILFFSILNIHVGMAGPEQVSMHIYGNVVDQGCDVATKSALQNIHIGDFNISDFQAANTVSTAADLNIDITGCAAGITGADVLFSGEADTLAPTLLKLTDTGGSGGMATGIAVQILDAQSQQEIPLNQVQPLTPLKAGDNTLKYQLRYKSTKAGATGGNATAVLYFDLVYQ	YCBU_ECOLI	G
C6EI39_ECOBD	MLKRIIWILFLLGLTWGCELFAHDGTVNISGSFRRNTCVVAQDSKQINVQLGDVSLTRFSHGNYGPEKSFIINLQDCGTDVSTVDVTFSGTPDGVQSEMLSIESGTDAASGLAIAILDDAKILIPLNQASKDYSLHSGKVPLTFYAQLRPVNSDVQSGKVNASATFVLHYD	YCBV_ECOLI	G
C6EI17_ECOBD	MKTGIVTTLIALCLPVSVFATTLRLSTDVDLLVLDGKKVSSSLLRGADSIELDNGPHQLVFRVEKTIHLSNSEERLYISPPLVVSFNTQLINQVNFRLPRLENEREANHFDAAPRLELLDGDATPIPVKLDILAITSTAKTIDYEVEVERYNKSAKRASLPQFATMMADDSTLLSGVSELDAIPPQSQVLTEQRLKYWFKLADPQTRNTFLQWAEKQPSS	YCCT_ECOLI	G
C6EGT9_ECOBD	MNMMRIFYIGLSGVGMMFSSMASGNDAGGLQSPACGVVCDPYICVSSDGISPALTRKYLGEKAAENLQSLQGYDPSEFTFSNGVFCDVKEKLCRDDRYFGVDGKRSGKINQTTTKMLFMCRE	YCGJ_ECOLI	G
C6EGP4_ECOBD	MVFHFLPEVTDVLSRFVPRIISFYLLLLAAGGTANAQSTFEQKAANPFDNNNDGLPDLGMAPENHDGEKHFAEIVKDFGETSMNDNGLDTGEQAKAFALGKVRDALSQQVNQHVESWLSPWGNASVDVKVDNEGHFTGSRGSWFVPLQDNDRYLTWSQLGLTQQDDGLVSNVGVGQRWARGNWLVGYNTFYDNLLDENLQRAGFGAEAWGEYLRLSANFYQPFAAWHEQTAT	YCHO_ECOLI	G
C6EEV6_ECOBD	MFKARICGWIGLLPLFMLSLPVQAELRCVANAVDIEQFFSAATAEDKQQVEQAINSSVNLVPFGLSASDWKVHRGDLVVEGNIESNQKLIVLGNLTVKGNISTFSLSNPWVILGNVTATNIVTDSPLLIAGSINASGLVFIDSYYDNPSTIKGSINARGIFINDIIAPVVASSTNSEFMVRASDKNDTENVKKALMIINPDAYYWGLINDEDALKEIFKRSNIRMAGNVCNQ	YDBD_ECOLI	G
C6EEW1_ECOBD	MKKTLLLCAFLVGLVSSNVMALTLDEARTQGRVGETFYGYLVALKTDAETEKLVTDINAERKASYQQLAKQNNVSADDIAKLAGQKLVARAKPGEYVQGINGKWMRKS	YDBL_ECOLI	G
C6EEU3_ECOBD	MKKLALILFMGTLVSFYADAGRKPCSGSKGGISHCTAGGKFVCNDGSISASKKTCTN	YDCA_ECOLI	G
C6EES3_ECOBD	MSKTFARSSLCALSMTIMTAHAAEPPTNLDKPEGRLDIIAWPGYIERGQTDKQYDWVTQFEKETGCAVNVKTAATSDEMVSLMTKGGYDLVTASGDASLRLIMGKRVQPINTALIPNWKTLDPRVVKGDWFNVGGKVYGTPYQWGPNLLMYNTKTFPTPPDSWQVVFVEQNLPDGKSNKGRVQAYDGPIYIADAALFVKATQPQLGISDPYQLTEEQYQAVLKVLRAQHSLI	YDCS_ECOLI	G
C6EEP5_ECOBD	MKLKIVAVVVTGLLAANVAHAAEVYNKDGNKLDLYGKVTALRYFTDDKRDDGDKTYARLGFKGETQINDQMIGFGHWEYDFKGYNDEANGSRGKNL	YDDL_ECOLI	G
C6EDV0_ECOBD	MKFQAIVLASFLVMPYALADDQGGLKQDAAPPPPHAIEDGYRGTDDAKKMTVDFAKNMHDGASVSLRGNLISHKGEDRYVFRDKSGEINVVIPAAVFDGREVQPDQMINISGSLDKKSAPAVVRVTHLQK	YDEI_ECOLI	G
C6EEL5_ECOBD	MGKTISIKVLFGIYLLLMAGKVFAFSCNVDGGSSIGAGTTSVYVNLDPVIQPGQNLVVDLSQHISCWNDYGGWYDTDHINLVQGSAFAGSLQSYKGSLYWNNVTYPFPLTTNTNVLDIGDKTPMPLPLKLYITPVGAAGGVVIKAGEVIARIHMYKIATLGSGNPRNFTWNIISNNNVVMPTGGCTVDSRNVTVDLPDFPGSAEIPLGVYCSSEQKLSFYLSGATTDSSRQV	YDEQ_ECOLI	G
C6EEL4_ECOBD	MKRLHKRFLLATFCALFTATLQAADVTITVNGRVVAKPCTIQTKEANVNLGDLYTRNLQQPGSASGWHNITLSLTDCPVETSAVTAIVTGSTDNTGYYKNEGTAENIQIELRDDQDAALKNGDSKTVIVDEITRNAQFPLKARAITVNGNASQGTIEALINVIYTWQ	YDER_ECOLI	G
C6ECU8_ECOBD	MARINRISITLCALLFTTLPLTPMAHASKQARESSATTHITKKADKKKSTATTKKTQKTAKKAASKSTTKSKTASSVKKSSITASKNAKTRSKHAVNKTASASFTEKCTKRKGYKSHCVKVKNAASGTLADAHKAKVQKATKVAMNKLMQQIGKPYRWGGSSPRTGFDCSGLVYYAYKDLVKIRIPRTANEMYHLRDAAPIERSELKNGDLVFFRTQGRGTADHVGVYVGNG	YDHO_ECOLI	G
C6ECT4_ECOBD	MSFTRRKFVLGMGTVIFFTGSASSLLANTRQEKEVRYAMIHDESRCNGCNICARACRKTNHVPAQGSRLSIAHIPVTDNDNETQYHFFRQSCQHCEDAPCIDVCPTGASWRDEQGIVRVEKSQCIGCSYCIGACPYQVRYLNPVTKVADKCDFCAESRLAKGFPPICVSACPEHALIFGREDSPEIQAWLQQNKYYQYQLPGAGKPHLYRRFGQHLIKKENV	YDHX_ECOLI	G
C6ECI6_ECOBD	MKKIPLGTTDITLSRMGLGTWAIGGGPAWNGDLDRQICIDTILEAHRCGINLIDTAPGYNFGNSEVIVGQALKKLPREQVVVETKCGIVWERKGSLFNKVGDRQLYKNLSPESIREEVEASLQRLGIDYIDIYMTHWQSVPPFFTPIAETVAVLNELKAEGKIRAIGAANVDADHIREYLQYGELDIIQAKYSILDRAMENELLPLCRDNGIVVQVYSPLEQGLLTGTITRD	YDJG_ECOLI	G
C6EBV0_ECOBD	MFKFLVLTLGIISCQVYAEDTLIVNDHDISAIKDCWQKNSDDDTDVNVIKSCLRQEYNLVDAQLNKAYGEAYRYIEQVPRTGVKKPDTEQLNLLKKSQRAWLDFRDKECELILSNEDVQDLSDPYSESEWLSCMIIQTNTRTRQLQLYRNSEDFYPSPLTRG	YECT_ECOLI	G
C6E9X1_ECOBD	MSGEKKAKGWRFYGLVGFGAIALLSAGVWALQYAGSGPEKTLSPLVVHNNLQIDLNEPDLFLDSDSLSQLPKDLITIPFLHDVLSEDFVFYYQNHADRLGIEGSIRRIVYEHDLTLKDKLFSSLLDQPAQAALWHDKQGHLSHYMVLIQRSGLSKLLEPLLFAATSDSQLSKTEISSIKINSETVPVYQLRYNGNNALMFATYQDKMLVFSSTDMLFKDDQQDTEATAIAGD	YFAA_ECOLI	G
C6E9X5_ECOBD	MRKIFLPLLLVALSPVAHSEGVQEVEIDAPLSGWHPAEGEDASFSQSINYPASSVNMADDQNISAQIRGKIKNYAAAGKVQQGRLVVNGASMPQRIESDGSFARPYIFTEGSNSVQVISPDGQSRQKMQFYSTPGTGTIRARLRLVLSWDTDNTDLDLHVVTPDGEHAWYGNTVLKNSGALDMDVTTGYGPEIFAMPAPIHGRYQVYINYYGGRSETELTTAQLTLITDEGS	YFAP_ECOLI	G
C6E9X4_ECOBD	MNWRRIVWLLALVTLPTLAEETPLQLVLRGAQHDQLYQLSSSGVTKVSALPDSLTTPLGSLWKLYVYAWLEDTHQPEQPYQCRGNSPEEVYCCQAGESITRDTALVRSCGLYFAPQRLHIGADVWGQYWQQRQAPAWLASLTTLKPETSVTVKSLLDSLATLPAQNKAQEVLLDVVLDEAKIGVASMLGSRVRVKTWSWFADDKQEIRQGGFAGWLTDGTPLWVTGSGTSKT	YFAQ_ECOLI	G
C6E9X3_ECOBD	MDTQRFQSQFHWHLSFKFSGAIAACLSLSLVGTGLANADDSLPSSNYAPPAGGTFFLLADSSFSSSEEAKVRLEAPGRDYRRYQMEEYGGVDVRLYRIPDPMAFLRQQKNLHRIVVQPQYLGDGLNNTLTWLWDNWYGKSRRVMQRTFSSQSRQNVTQALPELQLGNAIIKPSRYVQNNQFSPLKKYPLVEQFRYPLWQAKPFEPQQGVKLEGASSNFISPQPGNIYIPLGQ	YFAS_ECOLI	G
C6E9X2_ECOBD	MRHGLLALICWLCCVVVHSEMLNVEQSGLFRAWFVRIAQEQLRQGPSPRWYQQDCAGLVRFAANETLKVHDSKWLKSNGLSSQYLPPEMTLTPEQRQLAQNWNQGNGKTGPYVTAINLIQYNSQFIGQDINQALPGDMIFFDQGDAQHLMVWMGRYVIYHTGSATKTDNGMRAVSLQQLMTWKDTRWIPNDSNPNFIGIYRLNFLVR	YFAT_ECOLI	G
C6ELC1_ECOBD	MKTIWILFCLLITWLSSTSVQASVTFGSVDVLYGASGQSDPTMEFYFTIISPRNGAYTAKYYDPHAVPRNNDYLVTDQWSGPGAAPIIQIVGFGNAGASQCPGLPSGRNCQYLTFSITIDAADDFGCPWLASVYSVVTDYGASYRAPTANSTVCPTVPVDTFDVSWSENRVNHNLGISLHSTGGFIEKTVSTYLMESNKLCDSSVMDRRGDYCRFVSGLITFSSYGCDNAKV	YFCO_ECOLI	G
C6ELC0_ECOBD	MTRNQTYYTRYTAGSLLGLVLLAQGTATSAKNNLHFTGNLIDKSCTLVAPGGLLAEVRFPTISSRDLSTQMQSGKVSMAFELENCKGSSQSQNSVKVTFTGTEDTGQPGFLALDSDSQAQGVGIGIETVDGVPVKINNNSGATFVLSDGSNTLLFNTWVQAKSGRDVTLGNFTATATATFEYL	YFCP_ECOLI	G
C6ELB9_ECOBD	MKQIAFFIMLVSYATVVSSSPDITFHGNLIAPPTCIVSENKTIEIAFNEVIISDISGDNYKREVPYSVECDSENTDTGIQMKLTWTGVETDFNDSAVETDVVGLGVELQQNGQRFQQGKAINISKTNLPKLHAVLVKKSGAVLSEGAFEAYATLQVDYQ	YFCQ_ECOLI	G
C6ELB8_ECOBD	MKNILLTMVGGLLICTTVGELTYAGSKPVNMVLRVQVDGPPPCTVTGSDVDFGDVLIRRIDGSQYLQPVTYKLDCGQRLTGADDLRMQLQGPTSVINGETVLNTGIDGFGIRIQNATNDSLITVGSSAWLPFSIDNQPTLEAVPVKQNGVSLVSSAFSATATMVVDYQ	YFCR_ECOLI	G
C6ELB7_ECOBD	MSDLLCSAKLGATTLALLLSAASLSAQASVTPDRTRLIFNESDKSISVTLRNNDPKLPYLAQSWIEDEKGNKISSPLTVLPPVQRIDSMMNGQVKVQGMPDINKLPADRESMFYFNVREIPPKSDKPNTLQIALQTRIKLFWRPKALENTSMKSPWQHKVTLTRSGQAFTVNNPTPYYVIISNASAQKNGNPATGFSPLVIEPKTTVPLNVKMDSVPVLTYVNDFGARMPLF	YFCS_ECOLI	G
C6ELB6_ECOBD	MPDHSLFRLRILPWCIALAMSGSYSSVWAEDDIQFDSRFLELKGDTKIDLKRFSSQGYVEPGKYNLQVQLNKQPLAEEHDIYWYAGEDDASKTYACLTPELVAQFGLKEDVAKNLQWSHDGKCLKPGQLEGMEIKADLSQSALVISLPQAYLEYTWPDWDPPSRWDDGISGIIADYSITAQTRHEENGGDDSNEISGNGTVGVNLGPWRVRADWQTDYQHTRSNDDDDEFSG	YFCU_ECOLI	G
C6ELB5_ECOBD	MSKFVKTAIAAAMVMGAFTSTATIAAGNNGTARFYGTIEDSVCSIVPDDHKLEVDMGDIGAEKLKNNGTTTPKNFQIRLQDCVFDTQETMTTTFTGTVSSANSGNYYTIFNTDTGAAFNNVSLAIGDSLGTSYKSGMGIDQKIVKDTATNKGKAKQTLNFKAWLVGAADAPDLGNFEANTTFQITYL	YFCV_ECOLI	G
C6EL93_ECOBD	MKRLIMATMVTAILASSTVWAADNAPVAAQQQTQQVQQTQKTAAAERISEQGLYAMRDVQVARLALFHGDPEKAKELTNEASALLSDDSTEWAKFAKPGKKTNLNDDQYIVINASVGISESYVATPEKEAAIKIANEKMAKGDKKGAMEELRLAGVGVMENQYLMPLKQTRNALADAQKLLDKKQYYEANLALKGAEDGIIVDSEALFVN	YFDX_ECOLI	G
C6EL58_ECOBD	MKKIICLVITLLMTLPVYAKLTAHEEARINAMLEGLAQKKDLIFVRNGDEHTCDEAVSHLRLKLGNTRNRIDTAEQFIDKVASSSSITGKPYIVKMPGKSDENAQPFLHALIAQTDKTVPAKGN	YFEK_ECOLI	G
C6EKK3_ECOBD	MKKVFLCAILASLSYPAIASSLQDQLSAVAEAEQQGKNEEQRQHDEWVAERNREIQQEKQRRANAQAAANKRAATAAANKKARQDKLDAEASADKKRDQSYEDELRSLEIQKQKLALAKEEARVKRENEFIDQELKHKAAQTDVVQSEADANRNMTEGGRDLMKSVGKAEENKSDSWFN	YFGI_ECOLI	G
C6EJY9_ECOBD	MRFSHRLFLLLILLLTGAPILAQEPSDVAKNVRMMVSGIVSYTRWPALSGPPKLCIFSSSRFSTALQENAATSLPYLPVIIHTQQEAMISGCNGFYFGNESPTFQMELTEQYPSKALLLIAEQNTECIIGSAFCLIIHNNDVRFAVNLDALSRSGVKVNPDVLMLARKKNDG	YFIR_ECOLI	G
C6EJ45_ECOBD	MNREKGVSSLALVLMLLVLGSLLLQGMSQQDRSFASRVSMESQSLRRQAIVQSALAWGKMHSWQTQPAVQCSQYAETDAQVCLRLLADNEALLIAGYEGVSLWRTGEVIDGNIVFSPRGWSDFCPLKERALCQLP	YGDB_ECOLI	G
C6EIF5_ECOBD	MKKQWIVGTALLMLMTGNAWADGEPPTENILKDQFKKQYHGILKLDAITLKNLDAKGNQATWSAEGDVSSSDDLYTWVGQLADYELLEQTWTKDKPVKFSAMLTSKGTPASGWSVNFYSFQAAASDRGRVVDDIKTNNKYLIVNSEDFNYRFSQLESALNTQKNSIPALEKEVKALDKQMVAAQKAADAYWGKDANGKQMTREDAFKKIHQQRDEFNKQNDSEAFAVKYDKE	YGGM_ECOLI	G
C6EIE0_ECOBD	MARVVFRDARIYLIQWLTKIRHTLNQRQSLNTDKEHLRKIARGMFWLMLLIISAKMAHSLWRYISFSAEYTAVSQPVNKPSRVDAKTFDKNDVQLISQQNWFGKYQPVAAQVKQPEPVPVAETRLNVVLRGIAFGARPGAVIEEGGKQQVYLQGETLGSHNAVIEEINRDHVMLRYQGKIERLSLAEEERSTVAVTNKKAVSDEAKQAVAEPAVSVPVEIPAAVRQALAKDP	YGHF_ECOLI	G
C6EHV0_ECOBD	MSAFKKSLLVAGVAMILSNNVFADEGHGIVKFKGEVISAPCSIKPGDEDLTVNLGEVADTVLKSDQKSLAEPFTIHLQDCMLSQGGTTYSKAKVTFTTANTMTGQSDLLKNTKETEIGGATGVGVRILDSQSGEVTLGTPVVITFNNTNSYQELNFKARMESPSKDATPGNVYAQADYKIAYE	YGIL_ECOLI	G
C6EHX3_ECOBD	MYTRNLLWLVSLVSAAPLYAADVPANTPLAPQQVFRYNNHSDPGTLDPQKVEENTAAQIVLDLFEGLVWMDGEGQVQPAQAERWEILDGGKRYIFHLRSGLQWSDGQPLTAEDFVLGWQRAVDPKTASPFAGYLAQAHINNAAAIVAGKADVTSLGVKATDDRTLEVTLEQPVPWFTTMLAWPTLFPVPHHVIAKHGDSWSKPENMVYNGAFVLDQWVVNEKITARKNPKYR	YGIS_ECOLI	G
C6EHW9_ECOBD	MKKFAAVIAVMALCSAPVMAAEQGGFSGPSATQSQAGGFQGPNGSVTTVESAKSLRDDTWVTLRGNIVERISDDLYVFKDASGTINVDIDHKRWNGVTVTPKDTVEIQGEVDKDWNSVEIDVKQIRKVNP	YGIW_ECOLI	G
C6EHR6_ECOBD	MKIKTILTPVTCALLISFSAHAANADNYKNVINRTGAPQYMKDYDYDDHQRFNPFFDLGAWHGHLLPDGPNTMGGFPGVALLTEEYINFMASNFDRLTVWQDGKKVDFTLEAYSIPGALVQKLTAKDVQVEMTLRFATPRTSLLETKITSNKPLDLVWDGELLEKLEAKEGKPLSDKTIAGEYPDYQRKISATRDGLKVTFGKVRATWDLLTSGESEYQVHKSLPVQTEING	YGJK_ECOLI	G
C6EGM2_ECOBD	MKIKTTVAALSVLSVLSFGAFAADSIDAAQAQNLEAIGTVSVSGVASSPMDMREMLNKKAEEKGATAYQITEARSGDTWHATAELYK	YHCN_ECOLI	G
C6EEA0_ECOBD	MKLRSVTYALFIAGLAAFSTSSLAAQSLRFGYETSQTDSQHIAAKKFNDLLQERTKGELKLKLFPDSTLGNAQAMISGVRGGTIDMEMSGSNNFAGLSPVMNLLDVPFLFRDTAHAHKTLDGKVGDDLKASLEGKGLKVLAYWENGWRDVTNSRAPVKTPADLKGLKIRTNNSPMNIAAFKVFGANPIPMPFAEVYTGLETRTIDAQEHPINVVWSAKFFEVQKFLSLTHHA	YIAO_ECOLI	G
C6EDJ7_ECOBD	MKACLLLFFYFSLIGQLHGADVKIKENESVMGSTAMTYDLSEEKLMKLKYKSQHGDSEASFRLYQYYCFTKNNIDKQLRFLERSASQGNVTAQFNYGVFLSDTNPTLSEYYNLNRAIYWMEFAVNNGNIDAKSKLQELKKLKRMDRRKNKENP	YIBG_ECOLI	G
C6EDA8_ECOBD	MKPTTLLLIFTFFAMPGIVYAESPFSSLQSAKEKTTVLQDLRKICTPQASLSDEAWEKLMLSDENNKQHIREAIVAMERNNQSNYWEALGKVECPDM	YICS_ECOLI	G
C6EG84_ECOBD	MNIKIAALTLAIASGISAQWAIAADMPASPAPTIPVKQYVTQVNADNSVTFRYFAPGAKNVSVVVGVPVPDNIHPMTKDEAGVWSWRTPILKGNLYEYFFNVDGVRSIDTGTAMTKPQRQVNSSMILVPGSYLDTRSVAHGDLIAITYHSNALQFERQMYVWTPPGYTGMGEPLPVLYFYHGFGDTGRSAIDQGRIPQIMDNLLAEGKIKPMLVVIPDTETDAKGIIPEDFV	YIEL_ECOLI	G
C6EE71_ECOBD	MKNRLLILSLLVSVPAFAWQPQTGDIIFQISRSSQSKAIQLATHSDYSHTGMLVIRNKKPYVFEAVGPVKYTPLKQWIAHGEKGKYVVRRVEGGLSVEQQQKLAQTAKRYLGKPYDFSFSWSDDRQYCSEVVWKVYQNALGMRVGEQQKLKEFDLSNPLVQAKLKERYGKNIPLEETVVSPQAVFDAPQLTTVAKEWPLFSW	YIIX_ECOLI	G
C6EE64_ECOBD	MKASLALLSLLTAFTSHSLKSPAVPPTVVQIQANTNLAIADGARQQIGNTLFYDPAYVRLTYPGGDVPQERGVCSDVVIRALRSQKVDLQKLVHEDMAKNFAEYPQKWQLKRPDSNIDHRRVPNLETWFSRHDKTRPTSKNPSDYQAGDIVSWRLDNGLAHIGVVSDGFARDGTPLVIHNIGAGAQEEDVLFNWRMVGHYRYFVK	YIJF_ECOLI	G
C6EDZ8_ECOBD	MKKVLYGIFAISALAATSAWAAPVQVGEAAGSAATSVSAGSSSATSVSTVSSAVGVALAATGGGDGSNTGTTTTTTTSTQ	YJBE_ECOLI	G
C6EDZ6_ECOBD	MIKQTFVALLLSVGASSVFAAGTVKVFSNGSSEAKTLTGAEHLIDLVGQPRLANSWWPGAVISEELATAAALRQQQALLTRLAELAADSSADDAAAINALRQQIQALKVTGRQKINLDPDIVRVAERGNPPLQGNYTLWVGPPPSTVTLFGLISRPGKQPFTPGRDVASYLSGQNLLSGADRSYAWVVYPDGRTQKAPVAYWNKRHVEPMPGSIIYVGLADSVWSETPDALN	YJBG_ECOLI	G
C6ED47_ECOBD	MKKIIALMLFLTFFAHANDSEPGSQYLKAAEAGDRRAQYFLADSWFSSGDLSKAEYWAQKAADSGDADACALLAQIKITNPVSLDYPQAKVLAEKAAQAGSKEGEVTLAHILVNTQAGKPDYPKAISLLENASEDLENDSAVDAQMLLGLIYANGVGIKADDDKATWYFKRSSAISRTGYSEYWAGMMFLNGEEGFIEKNKQKALHWLNLSCMEGFDTGCEEFEKLTNG	YJCO_ECOLI	G
C6ED40_ECOBD	MNNSRLFRLSRIVIALTAASGMMVNTANAKEEAKAATQYTQQVNQNYAKSLPFSDRQDFDDAQRGFIAPLLDEGILRDANGKVYYRADDYKFDINAAAPETVNPSLWRQSQINGISGLFKVTDKMYQVRGQDISNITFVEGEKGIIVIDPLVTPPAAKAALDLYFQHRPQKPIVAVIYTHSHTDHYGGVKGIISEVDVKSGKVQVIAPAGFMDEAISENVLAGNIMSRRALY	YJCS_ECOLI	G
C6ECG1_ECOBD	MKQLLASPSLQLVTYPASATAQSAEFASADCVTGLNEIGQISVSNISGDPQDVERIVALKADEQGASWYRIITMYEDQQPDNWRVQAILYA	YJFN_ECOLI	G
C6ECF0_ECOBD	MFSRVLALLAVLLLSANTWAAIEINNHQARNMDDVQSLGVIYINHNFATESEARQALNEETDAQGATYYHVILMREPGSNGNMHASADIYR	YJFY_ECOLI	G
C6EBL0_ECOBD	MMKTVKHLLCCAIAASALISTGVHAASWKDALSSAASELGNQNSTTQEGGWSLASLTNLLSSGNQALSADNMNNAAGILQYCAKQKLASVTDAENIKNQVLEKLGLNSEEQKEDTNYLDGIQGLLKTKDGQQLNLDNIGTTPLAEKVKTKACDLVLKQGLNFIS	YJJA_ECOLI	G
C6ELS8_ECOBD	MFKKSVLFATLLSGVMAFSTNADDKIILKHISVSSVSASPTVLEDAIADIARKYNASSWKVTSMRIDNNSTATAVLYK	YKGI_ECOLI	G
C6EA35_ECOBD	MSNLNPCMTCGACCAFFRVSFYWAEADDAGGTIPARLTEQISPFHRCMSGTNQKNPRCIALAGTPGKNACCTIYKNRSSTCREFAMSGENGVVNEACNRARAKYGLTPL	YKGJ_ECOLI	G
C6EIU6_ECOBD	MHRQFFFLVPLICLSSALWAASATVNVEVLQDKLDHPWALAFLPDNHGMLITLRGGELRHWQAGKGLSAPLSGVPDVWAHGQGGLLDVVLAPDFAQSRRIWLSYSEVGDDGKAGTAVGYGRLSDDLSKVTDFRTVFRQMPKLSTGNHFGGRLVFDGKGYLFIALGENNQRPTAQDLDKLQGKLVRLTDQGEIPDDNPFIKESGARAEIWSYGIRNPQGMAMNPWSNALWLNE	YLII_ECOLI	G
C6EHG8_ECOBD	MFRPFLNSLMLGSLFFPFIAIAGSTVQGGVIHFYGHIVEPACDVSTQSSPVEMNCPQNGSIPGKTYSSKALMSGNVKNAQIASVKVQYLDKQKKLAVMNIEYN	YMDA_ECOLI	G
C6EGU4_ECOBD	MKKFALLAGLFVFAPMTWAQDYNIKNGLPSETYITCAEANEMAKTDSAQVAEIVAVMGNASVASRDLKIEQSPKLSAKVVEKLNQVCAKDPQMLLITAIDDTMRAIGKK	YMGD_ECOLI	G
C6EES7_ECOBD	MAGHKGHEFVWVKNVDHQLRHEADSDELRAVAEESAEGLREHFYWQKSRKPEAGQR	YNCJ_ECOLI	G
C6EDR2_ECOBD	MKLSTCCAALLLALASPAVLAAPGSCERIQSDISQRIINNGVPESSFTLSIVPNDQVDQPDSQVVGHCANDTHKILYTRTTSGNVSAPAQSSQDGAPAEPQ	YNFD_ECOLI	G
C6ECK0_ECOBD	MKRVSQMTALAMALGLACASSWAAELAKPLTLDQLQQQNGKAIDTRPSAFYNGWPQTLNGPSGHEPAALNLSASWLDKMSTEQLNAWIKQHNLKTDAPVALYGNDKDVDAVKTRLQKAGLTHISILSDALSEPSRLQKLPHFEQLVYPQWLHDLQQGKEVTAKPAGDWKVIEAAWGAPKLYLISHIPGADYIDTNEVESEPLWNKVSDEQLKAMLAKHGIRHDTTVILYGRD	YNJE_ECOLI	G
C6ECJ7_ECOBD	MSRALFAVVLAFPLIALANPHYRPDVEVNVPPEVFSSGGQSAQPCTQCCVYQDQNYSEGAVIKAEGILLQCQRDDKTLSTNPLVWRRVKP	YNJH_ECOLI	G
C6EBY8_ECOBD	MASTARSLRYALAILTTSLVTPSVWAHAHLTHQYPAANAQVTAAPQAITLNFSEGVETGFSGAKITGPKNENIKTLPAKRNEQDQKQLIVPLADSLKPGTYTVDWHVVSVDGHKTKGHYTFSVK	YOBA_ECOLI	G
C6EB93_ECOBD	MAIRLYKLAVALGVFMVSAPAFSHGHHSHGKPLTEVEQKAANGVFDDANVQNRTLSDWDGVWQSVYPLLQSGKLDPVFQKKADADKTKTFAEIKDYYHKGYATDIEMIGIEDGIVEFHRNNETTSCKYDYDGYKILTYKSGKKGVRYLFECKDPESKAPKYIQFSDHIIAPRKSSHFHIFMGNDSQQSLLNEMENWPTYYPYQLSSEEVVEEMMSH	YODA_ECOLI	G
C6EBG4_ECOBD	MKKMQSIVLALSLVLVAPMAAQAAEITLVPSVKLQIGDRDNRGYYWDGGHWRDHGWWKQHYEWRGNRWHPHGPPPPPRHHKKAPHDHHGGHGPGKHHR	YPEC_ECOLI	G
C6EL78_ECOBD	MFRSLFLAAALMAFTPLAANAGEITLLPSIKLQIGDRDHYGNYWDGGHWRDRDYWHRNYEWRKNRWWRHDNGYHRGWDKRKAYERGYREGWRDRDDHRGKGRGHGHRH	YPEC_ECOLI	G
C6EKP6_ECOBD	MRYRIFLLFFFALLPTSLVWAAPAQRAFSDWQVTCNNQNFCVARNTGDHNGLVMTLSRSAGAHTDAVLRIERGGLKSPEASEGEIAPRLLLDGEPLALSGDKWRISPWLLVTDDTATITAFLQMIQEGKAITLRDGDQTISLSGLKAALLFIDAQQKRVGSETAWIKKGDEPPLSVPPAPALKEVAVVNPTPTPLSLEERNDLLDYGNWRMNGLRCSLDPLRREVNVTALTD	YPFG_ECOLI	G
C6EKF9_ECOBD	MPKKMRTTRNLLLMATLLGSALFARAADKEMTIGAIYLDTQGYYAGVRQGVQDAAKDSSVQVQLIETNAQGDISKESTFVDTLVARNVDAIILSAVSENGSSRTVRRASEAGIPVICYNTCINQKGVDKYVSAYLVGDPLEFGKKLGNAAADYFIANKIDQPKIAVINCEAFEVCVQRRKGFEEVLKSRVPGAQIVANQEGTVLDKAISVGEKLIISTPDLNAIMGESGGAT	YPHF_ECOLI	G
C6EHY0_ECOBD	MKIILLFLAALASFTVHAQPPSQTVEQTVRHIYQNYKSDATAPYFGETGERAITSARIQQALTLNDNLTLPGNIGWLDYDPVCDCQDFGDLVLESVAITQTDADHADAVVRFRIFKDDKEKTTQTLKMVAENGRWVIDDIVSNHGSVLQAVNSENEKTLAALASLQKEQPEAFVAELFEHIADYSWPWTWVVSDSYRQAVNAFYKTTFKTANNPDEDMQIERQFIYDNPICF	YQHG_ECOLI	G
C6EHU7_ECOBD	MRYLLIVITFFMGFSSLPAWAMDCYAEHEGGNTVVIGYVPRISIPSDGKKGDKIWQSSEYFMNVFCNNALPGPSPGEEYPSAWANIMMLLASGQDFYNQNSYTFGVTYNGVDYDSTSPLPIAAPVCIDIKGAGTFGNGYKKPAVCSGGPEPQLSVTFPVRVQLYIKLAKNANKVNKKLVLPDEYIALEFKGMSGAGAIEVDKNLTFRIRGLNNIHVLDCFVNVDLEPADGVV	YQII_ECOLI	G
C6EHP6_ECOBD	MKYRIALAVSLFALSAGSYATTLCQEKEQNILKEISYAEKHQNQNRIDGLNKALSEVRANCSDSQLRADHQKKIAKQKDEVAERQQDLAEAKQKGDADKIAKRERKLAEAQEELKKLEARDY	YQJC_ECOLI	G
C6EH83_ECOBD	MNKGTKIAIAGLLALFAGNAAATDGEIVFDGEILKSACEINDSDKKIEVALGHYNAEQFRSVGDRSPKIPFTIPLVNCPMTGWEHDNGNVEASFRLWLETRDNGTVPNFPNLAKVGSFAGIAATGVGIRIDDAESGNIMPLNAMGNDNTVYQIPADSNGIVNVDLIAYYVSTVEASEITPGEADAVVNVTLDYR	YRAH_ECOLI	G
C6EH82_ECOBD	MSKRTFAVILTLLCSFCIGQALAGGIVLQRTRVIYDASRKEAALPVANKGAETPYLLQSWVDNIDGKSRAPFIITPPLFRLEAGDDSSLRIIKTADNLPENKESLFYINVRTIPAKKKSDDVNANELTLVFKTRIKMFYRPAHLKGRVNDAWKSLEFKRSDHSLNIYNPTEYYVVFAGLAVDKIDLTSKIEYIAPGEHKQLPLPASGGKNVKWAAINDYGGSSGTETRPLQ	YRAI_ECOLI	G
C6EH80_ECOBD	MKRAPLITGLLLISTSCAYASSGGCGADSTSGATNYSSVVDDVTVNQTDNVTGREFTSATLSSTNWQYACSCSAGKAVKLVYMVSPVLTTTGHQTGYYKLNDSLDIKTTLQANDIPGLTTDQVVSVNTRFTQIKNNTVYSAATQTGVCQGDTSRYGPVNIGANTTFTLYVTKPFLGSMTIPKTDIAVIKGAWVDGMGSPSTGDFHDLVKLSIQGNLTAPQSCKINQGDVIKV	YRAK_ECOLI	G
C6EFI1_ECOBD	MAFKIWQIGLHLQQQEAVAVAIVRGAKECFLQRWWRLPLENDIIKDGRIVDAQQLAKTLLPWSRELPQRHHIMLAFPASRTLQRSFPRPSMSLGEREQTAWLSGTMARELDMDPDSLRFDYSEDSLSPAYNVTAAQSKELATLLTLAERLRVHVSAITPDASALQRFLPFLPSHQQCLAWRDNEQWLWATRYRWGRKLAVGMTSAKELAAALSVDPESVAICGEGGFDPWEA	YRFD_ECOLI	G
C6EE16_ECOBD	MKRNTKIALVMMALSAMAMGSTSAFAHGGHGMWQQNAAPLTSEQQTAWQKIHNDFYAQSSALQQQLVTKRYEYNALLAANPPDSSKINAVAKEMENLRQSLDELRVKRDIAMAEAGIPRGTGMGYGGCGGGGHMGMGHW	ZRAP_ECOLI	G
C6EJ67_ECOBD	MKTRHFIYALSLLACVSSSALAKDLNLPVVSKGFQHEFWQTVKMGTEAAAKELGDKTSYVGPADETQIAEQIQLVENAMAQKPNGLLLAALDANALAPLVETANSRGIKVVTFDSGINSDIPVSFVATNNRKAGAQAADALASQVNNKGKVGIIAHVAGTSSAIERSEGFMERMKEKYPDIKVLPVQYSDGDPQKAMDKTIDMIQANPDLAGIYGTNEGSTLGVANAIDSQN	RBSB_ECOLI	G
C6EIT4_ECOBD	MLGKVFFVVLSCSLLLNPLTTYAKNYPCSGKKGGVSHCTSDGKFVCNDGTISKSKKICTKNSR	YDCA_ECOLI	G
C6EAN2_ECOBD	MMSIFIMTLSLFMAPSSGGAFPFQRPAEIVGLPPFAMQAVYR		G
C6EAN3_ECOBD	MTKSTTMMIHFIMTLSLFMAPSSGGAFPFQRPAEIVGLPPFALNSVYR		G
C6EAN4_ECOBD	MTKSTTMMSSFIMTLSLFKAPSSGGAFPFQRPAEIFGLPPFALYAVYR		G
C6EB33_ECOBD	MKWLLLITLSLYSFIVQSAPCALTNVGEQRGTYILKPLSMKGNLTAEKIENTGNIIECTDLQETTNAIKVHFLTQNALKFKVGSRHYIINFPFEYDGKKIELPGKSSYNLEEMLSAINFTIPYSIASVSDSSNTADIFPGTPFPLLFEIEVSSCTGNNTNCNSVRFNYNLNTILQVNLMTCGFEDQSIDTGRFVLSRINNENYQFHHIRFDCIQGEQGELVFEPSDVEYYFE		G
C6EE72_ECOBD	MMKKIIPAVVCLLLCSCSTFPQAVAPVNNDFAGQHNIYIVSHGWHTGIVVPAAIVNRVLPQLDARFAQPKWYEIGWGDKGFYQAQEITSRLTLQAMFWSTGAVMHVVAFSAPPERYFPGSEVKPLTINNGQLATLMLFIGRSFSRSEAGNVIPLKKGIYGDSQFYAANGRYGILNTCNKWTAKGLQSAGIEIEPALKLTAGSVISAMP		G
C6EF69_ECOBD	MNTKQSVAQLAVPHRKRLSSTMVVALLLCVVAGAVMINAADFPATAIETDPGASAFPTFYACALIVLAVLLVIRDLLQAKPASCANAQEKPAFRKTATGIAATAFYIVAMSYCGYLITTPVFLIVIMTLMGYRRWVLTPGIALLLTAILWLLFVEALQVPLPVGTFFE		G
C6EFM0_ECOBD	MNFTPIKANTRIATVSGNTSLITAKAEQQGEWTYYEATYTANTDIDTVNCAFYMTNKISNEPFYDDSTLTMTTPQIELGNTASSFIVTTMPTTRASDVVTIPSANNLSTRPFTVLCEVRRNWSTPPNVAPRIFDVGGHSIDDNYLSLGFVSTGKISANVGMVQPQISSDGERFIVGVRAKSDLSVNAICNGNYTTNLNGKIFGVTATSYRFGGQTAAGTRHLFGHIRNFRVW		G
C6EG07_ECOBD	MHYRNVVCLLSCSLFLSSAWGCRLDEPEHNIYQKQGKGVVYLRPYEKTNLSLYRDIIIPVTDESCRNAAADGQTLKP		G
C6EDS9_ECOBD	MLDTCRLASYVPKGKEKQAMKQQKAMLIALIVICLTVIVTALVTRKDLCEVRIRTGQTEVAVFTAYEPEE	HOKD_ECOLI	G
C6EFS4_ECOBD	MFKKGLLALALVFSLPVFAAEHWIDVRVPEQYQQEHVQGAINIPLKEVKERIATAVPDKNDTVKVYCNAGRQSGQAKEILSEMGYTHVENAGGLKDIAMPKVKG	PSPE_ECOLI	G
C6EIP4_ECOBD	MKGKSALTLLLAGIFSCGTCQATGAEVTSESVFNILNSTGAATDKSYLSLNPDKYPNYRLLIHSAKLKNEIKSHYTKDEIQGLLTLTENTRKLTLTEKPWGTFILASTFEDDKTAAETHYDGVWLRDSLWGYMALVSDQGNSVAAKKVLLTLWDYMSTPDQIKRMQDVISNPKRLDGVLILPT	YGEQ_ECOLI	G
C6EGJ1_ECOBD	MKKMMIATLAAASVLLAVANQAHAGATLDAVQKKGFVQCGISDGLPGFSYADADGKFSGIDVDICRGVAAAVFGDDTKVKYTPLTAKERFTALQSGEVDLLSRNTTWTSSRDAGMGMAFTGVTYYDGIGFLTHDKAGLKSAKELDGATVCIQAGTDTELNVADYFKANNMKYTPVTFDRSDESAKALESGRCDTLASDQSQLYALRIKLSNPAEWIVLPEVISKEPLGPVVR	YHDW_ECOLI	G
C6EFZ9_ECOBD	MAHRLLIGKGMITLNLKRIFLTLTLLPLFAVAADDCALSDPTLTVQAYTVNPQTERVKMYWQKANGEAWGTLHALLADMNSQGQVQMAMNGGIYDESYAPLGLYIENGQQKVALNLASGEGNFFIRPGGVFYVAGDKVGIVRLDAFKTSKEIQFAVQSGPMLMENSVINPRIHPNVASRKIRNGVGINKHGNAVFLLSQQATNFYDFACYAKAKLNVEQLLYLDGTISHMYM	YIGE_ECOLI	G
C6EFM4_ECOBD	MNAKIRYGLSAAVLALIAVGAPAPDILDQFLDEKEGNHTTAYRDGSGIWTICRGATMVDGKPVIPGMRLSKEKCDQVNAIERDKALAWVERNIKVPLTEPQKAGIASFCPYNIGPGKCFPSTFYKRLNAGDRKGACEAIRWWIKDGGRDCRIRSNNCYGQVIRRDQESALACWGIDQ		G
C6EIR4_ECOBD	MSTKFYTLLTDIGAAKLASAAALGVPLKITHMAVGDGGGVLPTPDAKQTALVNEKRRAALNMLYIDPQNSSQIIAEQVIPENEGGWWIREVGLFDESGALIAVGNCPESYKPQLAEGSGRTQTVRMVLITSSTDNITLKIDPAVVLATRKYVDDKVLELKVFVDDKMAKHLAAPDPHSQYAPKESPTLTGTPKAPTPAEGNNTTQIATTAFVQAALMALINGAPATLDTMKE		G
C6EIS2_ECOBD	MTRALAVVVALALVALGWQSWRLNSASHTIETQRAALKSKAQELTKKNSQLISLSILTETNNREQARLYAEAEQTSALLRQRQHRIEELKRENEDLRRWADTPLPADIIRLRERPALTGGTAYRQWLSASDAVSAGSGNAAH		G
C6EKD6_ECOBD	MPPSLRKAVAAAIGGGAIAIASVLITGPSGNDGLEGVSYIPYKDIVGVWTVCHGHTGKDIMLGKTYTKAECKALLNKDLATVARQINPYIKVDIPETTRGALYSFVYNVGAGNFRTSTLLRKINQGDIKGACDQLRRWTYAGGKQWKGLMTRREIEREICLWGQQ		G
C6EHH0_ECOBD	MKLLKVAAIAAIVFSGSALAGVVPQYGGGGNHGGGGNNSGPNSELNIYQYGGGNSALALQTDARNSDLTITQHGGGNGADVGQGSDDSSIDLTQRGFGNSATLDQWNGKNSEMTVKQFGGGNGAAVDQTASNSSVNVTQVGFGNNATAHQY	CSGA_ECOLI	F4
C6EHH1_ECOBD	MKNKLLFMMLTILGAPGIAAAAGYDLANSEYNFAVNELSKSSFNQAAIIGQAGTNNSAQLRQGGSKLLAVVAQEGSSNRAKIDQTGDYNLAYIDQAGSANDASISQGAYGNTAMIIQKGSGNKANITQYGTQKTAIVVQRQSQMAIRVTQR	CSGB_ECOLI	F4
C6EBR9_ECOBD	MKIKTLAIVVLSALSLSSTAALAAATTVNGGTVHFKGEVVNAACAVDAGSVDQTVQLGQVRTASLAQEGATSSAVGFNIQLNDCDTNVASKAAVAFLGTAIDAGHTNVLALQSSAAGSATNVGVQILDRTGAALTLDGATFSSETTLNNGTNTIPFQARYFATGAATPGAANADATFKVQYQ	FIMA1_ECOLI	F4
C6EBR5_ECOBD	MRNKPFYLLCAFLWLAVSHALAADSTITIRGYVRDNGCSVAAESTNFTVDLMENAAKQFNNIGATTPVVPFRILLSPCGNAVSAVKVGFTGVADSHNANLLALENTVSAASGLGIQLLNEQQNQIPLNAPSSALSWTTLTPGKPNTLNFYARLMATQVPVTAGHINATATFTLEYQ	FIMF_ECOLI	F4
C6EBR4_ECOBD	MKWCKRGYVLAAILALASATIQAADVTITVNGKVVAKPCTVSTTNATVDLGDLYSFSLMSAGAASAWHDVALELTNCPVGTSRVTASFSGAADSTGYYKNQGTAQNIQLELQDDSGNTLNTGATKTVQVDDSSQSAHFPLQVRALTVNGGATQGTIQAVISITYTYS	FIMG_ECOLI	F4
C6EBR3_ECOBD	MKRVITLFAVLLMGWSVNAWSFACKTANGTAIPIGGGSANVYVNLAPVVNVGQNLVVDLSTQIFCHNDYPETITDYVTLQRGSAYGGVLSNFSGTVKYSGSSYPFPTTSETPRVVYNSRTDKPWPVALYLTPVSSAGGGAIKAGSLIAVLILRQTNNYNSDDFQFVWNIYANNDVVVPTGGCDVSARDVTVTLPDYPGSVPIPLTVYCAKSQNLGYYLSGTTADAGNSIFTN	FIMH_ECOLI	F4
C6EHD7_ECOBD	MAFSQAVSGLNAAATNLDVIGNNIANSATYGFKSGTASFADMFAGSKVGLGVKVAGITQDFTDGTTTNTGRGLDVAISQNGFFRLVDSNGSVFYSRNGQFKLDENRNLVNMQGLQLTGYPATGTPPTIQQGANPTNISIPNTLMAAKTTTTASMQINLNSSDPLPTVTPFSASNADSYNKKGSVTVFDSQGNAHDMSVYFVKTGDNNWQVYTQDSSDPTGTAEPAMKLVFNA	FLGE_ECOLI	F4
C6EHD1_ECOBD	MSSLINNAMSGLNAAQAALNTASNNISSYNVAGYTRQTTIMAQANSTLGAGGWVGNGVYVSGVQREYDAFITNQLRAAQTQSSGLTARYEQMSKIDNMLSTSTSSLATQMQDFFTSLQTLVSNAEDPAARQALIGKSEGLVNQFKTTDQYLRDQDKQVNIAIGASVDQINNYAKQIASLNDQISRLTGVGAGASPNNLLDQRDQLVSELNQIVGVEVSVQDGGTYNITMANG	FLGK_ECOLI	F4
C6EHD0_ECOBD	MRFSTQMMYQQNMRGITNSQAEWMKYGEQMSTGKRVVNPSDDPIAASQAVVLSQAQAQNSQYTLARTFATQKVSLEESVLSQVTTAIQNAQEKIVYASNGTLSDDDRASLATDIQGLRDQLLNLANTTDGNGRYIFAGYKTETAPFSEANGDYVGGTESIKQQVDASRSMVIGHTGDKIFDSITSNAVAEPDGSASETNLFAMLDSAIAALKTPVADSEADKETAAAALDKT	FLGL_ECOLI	F4
C6EBD8_ECOBD	MAQVINTNSLSLITQNNINKNQSALSSSIERLSSGLRINSAKDDAAGQAIANRFTSNIKGLTQAARNANDGISVAQTTEGALSEINNNLQRVRELTVQATTGTNSESDLSSIQDEIKSRLDEIDRVSGQTQFNGVNVLAKNGSMKIQVGANDNQTITIDLKQIDAKTLGLDGFSVKNNDTVTTSAPVTAFGATTTNNIKLTGITLSTEAATDTGGTNPASIEGVYTDNGNDY	FLIC_ECOLI	F4
C6EBD7_ECOBD	MASISSLGVGSGLDLSSILDSLTAAQKATLTPISNQQSSFTAKLSAYGTLKSALTTFQTANTALSKADLFSATSTTSSTTAFSATTAGNAIAGKYTISVTHLAQAQTLTTRTTRDDTKTAIATSDSKLTIQQGGDKDPITIDISAANSSLSGIRDAINNAKAGVSASIINVGNGEYRLSVTSNDTGLDNAMTLSVSGDDALQSFMGYDASASSNGMEVSVAAQNAQLTVNNV	FLID_ECOLI	F4
C6EEL3_ECOBD	MKYNNIIFLGLCLGLTTYSALSADSVIKISGRVLDYGCTVSSDSLNFTVDLQKNSARQFPTTGSTSPAVPFQITLSECSKGTTGVRVAFNGIEDAENNTLLKLDEGSNTASGLGIEILDANMRPVKLNDLHAGMQWIPLVPEQNNILPYSARLKSTQKSVNPGLVRASATFTLEFQ	YDES_ECOLI	F4
C6EHD8_ECOBD	MSIAVTTTDPTNTGVSTTSSSSLTGSNAADLQSSFLTLLVAQLKNQDPTNPMENNELTSQLAQISTVSGIEKLNTTLGSISGQIDNSQSLQASNLIGHGVMIPGTTILAGTGSEEGAVTTTTPFGVELQQAADKVTATITDKNGAVVRTIDIGELTAGVHSFTWDGTLTDGSTAPNGSYNVAISASNGGTQLVAQPLQFALVQGVIRGNNGNTLDLGTYGTTTLDEVRQII	FLGD_ECOLI	F4
C6EK32_ECOBD	MKKLKINYLFIGILALLLAVALWPSIPWFGKADNRIAAIQARGELRVSTIHTPLTYNEINGKPFGLDYELAKQFADYLGVKLKVTVRQNISQLFDDLDNGNADLLAAGLVYNSERVKNYQPGPTYYSVSQQLVYKVGQYRPRTLGNLTAEQLTVAPGHVVVNDLQTLKETKFPELSWKVDDKKGSAELMEDVIEGKLDYTIADSVAISLFQRVHPELAVALDITDEQPVTWF	MLTF_ECOLI	F3
C6EE92_ECOBD	MLINRNIVALFALPFMASATASELSIGAGAAYNESPYRGYNENTKAIPLISYEGDSFYVRQTTLGFILSQSEKNELSLTASWMPLEFDPADNDDYAMQQLDKRDSTAMAGVAWYHHERWGTVKASAAADVLDNSNGWVGELSVFHKMQIGRLSLTPALGVLYYDENFSDYYYGISESESRRSGLASYSAQDAWVPYVSLTAKYPIVEHVVLMASAGYSELPEEITDSPMIDR	YIAT_ECOLI	F3
C6EKC7_ECOBD	MKKIALIIGSMIAGGIISAAGFTWVAKAEPPAEKTSTAERKILFWYDPMYPNTRFDKPGKSPFMDMDLVPKYADEESSASGVRIDPTQTQNLGVKTATVTRGPLTFAQSFPANVSYNEYQYAIVQARAAGFIDKVYPLTVGDKVQKGTPLLDLTIPDWVEAQSEYLLLRETGGTATQTEGILERLRLAGMPEADIRRLIATQKIQTRFTLKAPIDGVITAFDLRAGMNIAKD	CUSB_ECOLI	F2
C6EB73_ECOBD	MKRRLIIAASLFVFNLSSGFAAENIPFSPQPPEIHAGSWVLMDYTTGQILTAGNEHQQRNPASLTKLMTGYVVDRAIDSHRITPDDIVTVGRDAWAKDNPVFVGSSLMFLKEGDRVSVRDLSRGLIVDSGNDACVALADYIAGGQRQFVEMMNNYAEKLHLKDTHFETVHGLDAPGQHSSAYDLAVLSRAIIHGEPEFYHMYSEKSLTWNGITQQNRNGLLWDKTMNVDGLK	DACD_ECOLI	F2
C6EEP3_ECOBD	MDVSRRQFFKICAGGMAGTTVAALGFAPKQALAQARNYKLLRAKEIRNTCTYCSVGCGLLMYSLGDGAKNAREAIYHIEGDPDHPVSRGALCPKGAGLLDYVNSENRLRYPEYRAPGSDKWQRISWEEAFSRIAKLMKADRDANFIEKNEQGVTVNRWLSTGMLCASGASNETGMLTQKFARSLGMLAVDNQARVUHGPTVASLAPTFGRGAMTNHWVDIKNANVVMVMGGN	FDNG_ECOLI	F2
C6EJB4_ECOBD	MFSALRHRTAALALGVCFILPVHASSPKPGDFANTQARHIATFFPGRMTGTPAEMLSADYIRQQFQQMGYRSDIRTFNSRYIYTARDNRKSWHNVTGSTVIAAHEGKAPQQIIIMAHLDTYAPLSDADADANLGGLTLQGMDDNAAGLGVMLELAERLKNTPTEYGIRFVATSGEEEGKLGAENLLKRMSDTEKKNTLLVINLDNLIVGDKLYFNSGVKTPEAVRKLTRDRA	IAP_ECOLI	F2
C6EB97_ECOBD	MKKNQFLKESDVTAESVFFMKRRQVLKALGISATALSLPHAAHADLLSWFKGNDRPPAPAGKALEFSKPAAWQNNLPLTPADKVSGYNNFYEFGLDKADPAANAGSLKTDPWTLKISGEVAKPLTLDHDDLTRRFPLEERIYRMRCVEAWSMVVPWIGFPLHKLLALAEPTSNAKYVAFETIYAPEQMPGQQDRFIGGGLKYPYVEGLRLDEAMHPLTLMTVGVYGKALPPQ	YEDY_ECOLI	F2
C6ED36_ECOBD	MATPYISMAGIGKSFGPVHALKSVNLTVYPGEIHALLGENGAGKSTLMKVLSGIHEPTKGTITINNISYNKLDHKLAAQLGIGIIYQELSVIDELTVLENLYIGRHLTKKICGVNIIDWREMRVRAAMMLLRVGLKVDLDEKVANLSISHKQMLEIAKTLMLDAKVIIMDEPTSSLTNKEVDYLFLIMNQLRKEGTAIVYISHKLAEIRRICDRYTVMKDGSSVCSGIVSDV	ALSA_ECOLI	F1
C6EIJ1_ECOBD	MINEATLAESIRRLRQGERATLAQAMTLVESRHPRHQALSTQLLDAIMPYCGNTLRLGVTGTPGAGKSTFLEAFGMLLIREGLKVAVIAVDPSSPVTGGSILGDKTRMNDLARAEAAFIRPVPSSGHLGGASQRARELMLLCEAAGYDVVIVETVGVGQSETEVARMVDCFISLQIAGGGDDLQGIKKGLMEVADLIVINKDDGDNHTNVAIARHMYESALHILRRKYDEWQ	ARGK_ECOLI	F1
C6EEN3_ECOBD	MTQPVLDIQQLHLSFPGFNGDVHALNNVSLQINRGEIVGLVGESGSGKSVTAMLIMRLLPMGSYCVHRGQISLLGEDVLNAREKQLRQWRGARVAMIFQEPMTALNPTRRIGLQMMDVIRHHQPISRREARAKAIALLEEMQIPDAVEVMSRYPFELSGGMRQRVMIALAFSCEPQLIIADEPTTALDVTVQLQVLRLLKHKARASGTAVLFISHDMAVVSQLCDSVYVMYA	DDPD_ECOLI	F1
C6EEN4_ECOBD	MSDTLLTLRDVHINFPARKNWLGKTTEHVHAINGIDLQIRRGETLGIVGESGCGKSTLAQLLMGMLQPSHGQYIRSGSQRIMQMVFQDPLSSLNPRLPVWRIITEPLWIAKRSSEQQRRALAEELAVQVGIRPEYLDRLPHAFSGGQRQRIAIARALSSQPDVIVLDEPTSAMDISVQAQILNLLVTLQENHGLTYVLISHNVSVIRHMSDRVAVMYLGQIVELGDAQQVLT	DDPF_ECOLI	F1
C6EKJ8_ECOBD	MVPVVALVGRPNVGKSTLFNRLTRTRDALVADFPGLTRDRKYGRAEIEGREFICIDTGGIDGTEDGVETRMAEQSLLAIEEADVVLFMVDARAGLMPADEAIAKHLRSREKPTFLVANKTDGLDPDQAVVDFYSLGLGEIYPIAASHGRGVLSLLEHVLLPWMEDLAPQEEVDEDAEYWAQFEAEENGEEEEEDDFDPQSLPIKLAIVGRPNVGKSTLTNRILGEERVVVYD	DER_ECOLI	F1
C6EK99_ECOBD	MAIPKLQAYALPKSHDIPQNKVDWAFEPQRAALLIHDMQDYFVSFWGENCPMMEQVIANIAALRDYCKQHNIPVYYTAQPKEQSDEDRALLNDMWGPGLTRSPEQQKVVDRLTPDADDTVLVKWRYSAFHRSPLEQMLKESGRNQLIITGVYAHIGCMTTATDAFMRDIKPFMVADALADFSRDEHLMSLKYVAGRSGRVVMTEELLPAPIPASKAALREVILPLLDESDEP	ENTB_ECOLI	F1
C6EBK3_ECOBD	MAYRSAPLYEDVIWRTHLQPQDPTLAQAVRATIAKHREHLLEFIRLDEPAPLNAMTLAQWSSPNVLSSLLAVYSDHIYRNQPMMIRENKPLISLWAQWYIGLMVPPLMLALLTQEKALDVSPEHFHAEFHETGRVACFWVDVCEDKNATPHSPQHRMETLISQALVPVVQALEATGEINGKLIWSNTGYLINWYLTEMKQLLGEATVESLRHALFFEKTLTNGEDNPLWRTV	FHUF_ECOLI	F1
C6EB10_ECOBD	MSEDIFDAIIVGAGLAGSVAALVLAREGAQVLVIERGNSAGAKNVTGGRLYAHSLEHIIPGFADSAPVERLITHEKLAFMTEKSAMTMDYCNGDETSPSQRSYSVLRSKFDAWLMEQAEEAGAQLITGIRVDNLVQRDGKVVGVEADGDVIEAKTVILADGVNSILAEKLGMAKRVKPTDVAVGVKELIELPKSVIEDRFQLQGNQGAACLFAGSPTDGLMGGGFLYTNENT	FIXC_ECOLI	F1
C6EBC6_ECOBD	MSNLTGTDKSVILLMTIGEDRAAEVFKHLSQREVQTLSAAMANVTQISNKQLTDVLAEFEQEAEQFAALNINANDYLRSVLVKALGEERAASLLEDILETRDTASGIETLNFMEPQSAADLIRDEHPQIIATILVHLKRAQAADILALFDERLRHDVMLRIATFGGVQPAALAELTEVLNGLLDGQNLKRSKMGGVRTAAEIINLMKTQQEEAVITAVREFDGELAQKIIDE	FLIG_ECOLI	F1
C6EBC3_ECOBD	MAEHGALATLKDLAEKEVEDAARLLGEMRRGCQQAEEQLKMLIDYQNEYRNNLNSDMSAGITSNRWINYQQFIQTLEKAITQHRQQLNQWTQKVDIALNSWREKKQRLQAWQTLQERQSTAALLAENRLDQKKMDEFAQRAAMRKPE	FLIJ_ECOLI	F1
C6EBC1_ECOBD	MTDYAISKKSKRSLWIPILVFITLAACASAGYSYWHSHQVAADDKAQQRVVPSPVFYALDTFTVNLGDADRVLYIGITLRLKDEATRSRLSEYLPEVRSRLLLLFSRQDAAVLATEEGKKNLIAEIKTTLSTPLVAGQPKQDVTDVLYTAFILR	FLIL_ECOLI	F1
C6EBC0_ECOBD	MGDSILSQAEIDALLNGDSEVKDEPTASVSGESDIRPYDPNTQRRVVRERLQALEIINERFARHFRMGLFNLLRRSPDITVGAIRIQPYHEFARNLPVPTNLNLIHLKPLRGTGLVVFSPSLVFIAVDNLFGGDGRFPTKVEGREFTHTEQRVINRMLKLALEGYSDAWKAINPLEVEYVRSEMQVKFTNITTSPNDIVVNTPFHVEIGNLTGEFNICLPFSMIEPLRELLV	FLIM_ECOLI	F1
C6EBB9_ECOBD	MSDMNNPADDNNGAMDDLWAEALSEQKSTSSKSAAETVFQQFGGGDVSGTLQDIDLIMDIPVKLTVELGRTRMTIKELLRLTQGSVVALDGLAGEPLDILINGYLIAQGEVVVVADKYGVRITDIITPSERMRRLSR	FLIN_ECOLI	F1
C6EL13_ECOBD	MKLVTVIIKPFKLEDVREALSSIGIQGLTVTEVKGFGRQKGHAELYRGAEYSVNFLPKVKIDVAIADDQLDEVIDIVSKAAYTGKIGDGKIFVAELQRVIRIRTGEADEAAL	GLNK_ECOLI	F1
C6E9W0_ECOBD	MKTRDSQSSDVIIIGGGATGAGIARDCALRGLRVILVERHDIATGATGRNHGLLHSGARYAVTDAESARECISENQILKRIARHCVEPTNGLFITLPEDDLSFQATFIRACEEAGISAEAIDPQQARIIEPAVNPALIGAVKVPDGTVDPFRLTAANMLDAKEHGAVILTAHEVTGLIREGATVCGVRVRNHLTGETQALHAPVVVNAAGIWGQHIAEYADLRIRMFPAKGS	GLPA_ECOLI	F1
C6E9V9_ECOBD	MRFDTVIMGGGLAGLLCGLQLQKHGLRCAIVTRGQSALHFSSGSLDLLSHLPDGQPVADIHSGLESLRQQAPAHPYSLLGPQRVLDLACQAQALIAESGAQLQGSVELAHQRITPLGTLRSTWLSSPEVPVWPLPAKKICVVGISGLMDFQAHLAAASLRELDLSVETAEIELPELDVLRNNATEFRAVNIARFLDNEENWPLLLDALIPVANTCEMILMPACFGLADDKLW	GLPB_ECOLI	F1
C6E9V8_ECOBD	MNDTSFENCIKCTVCTTACPVSRVNPGYPGPKQAGPDGERLRLKDGALYDEALKYCINCKRCEVACPSDVKIGDIIQRARAKYDTTRPSLRNFVLSHTDLMGSVSTPFAPIVNTATSLKPVRQLLDAALKIDHRRTLPKYSFGTFRRWYRSIAAQQAQYKDQVAFFHGCFVNYNHPQLGKDLIKVLNAMGTGVQLLSKEKCCGVPLIANGFTDKARKQAITNVESIREAVGV	GLPC_ECOLI	F1
C6EGE0_ECOBD	MRIHSPYPASWALAQRIGYLYSEGEIIYLADTPFERLLDIQRQVGQCQTMTSLSQADFEARLEAVFHQNTGESQQIAQDIDQSVDLLSLSEEMPANEDLLNEDSAAPVIRLINAILSEAIKETASDIHIETYEKTMSIRFRIDGVLRTILQPNKKLAALLISRIKVMARLDIAEKRIPQDGRISLRIGRRNIDVRVSTLPSIYGERAVLRLLDKNSLQLSLNNLGMTAADKQ	GSPE_ECOLI	F1
C6EB07_ECOBD	MILIIYAHPYPHHSHANKRMLEQARTLEGVEIRSLYQLYPDFNIDIAAEQEALSRADLIVWQHPMQWYSIPPLLKLWIDKVFSHGWAYGHGGTALHGKHLLWAVTTGGGESHFEIGAHPGFDVLSQPLQATAIYCGLNWLPPFAMHCTFICDDETLEGQARHYKQRLLEWQEAHHG	KEFF_ECOLI	F1
C6EDY7_ECOBD	MASVQLQNVTKAWGEVVVSKDINLDIHEGEFVVFVGPSGCGKSTLLRMIAGLETITSGDLFIGEKRMNDTPPAERGVGMVFQSYALYPHLSVAENMSFGLKLAGAKKEVINQRVNQVAEVLQLAHLLDRKPKALSGGQRQRVAIGRTLVAEPSVFLLDEPLSNLDAALRVQMRIEISRLHKRLGRTMIYVTHDQVEAMTLADKIVVLDAGRVAQVGKPLELYHYPADRFVAG	MALK_ECOLI	F1
C6EF95_ECOBD	MPQQIELRNIALQAAQPLVHGVSLTLQRGRVLALVGGSGSGKSLTCAATLGILPAGVRQTAGEILADGKPVSPCALRGIKIATIMQNPRSAFNPLHTMHTHARETCLALGKPADDATLTAAIEAVGLENAARVLKLYPFEMSGGMLQRMMIAMAVLCESPFIIADEPTTDLDVVAQARILDLLESIMQKQAPGMLLVTHDMGVVARLADDVAVMSQGKIVEQGDVETLFNAP	NIKD_ECOLI	F1
C6EF94_ECOBD	MTLLNVCGLSHHYAHGGFSGKHQHQAVLNNVSLTLKSGETVALLGRSGCGKSTLARLLVGLESPSQGNISWRGEPLAKLNRAQRKAFRRDIQMVFQDSISAVNPRKTVREILREPMRHLLSLKKSEQLARASEMLKAVDLDDSVLDKRPPQLSGGQLQRVCLARALAVEPKLLILDEAVSNLDLVLQAGVIRLLKKLQQQFGTACLFITHDLRLVERFCQRVMVMDNGQIVE	NIKE_ECOLI	F1
C6ED18_ECOBD	MQTIIRVEKLAKTFNQHQALHAVDLNIHHGEMVALLGPSGSGKSTLLRHLSGLITGDKSAGSHIELLGRTVQREGRLARDIRKSRANTGYIFQQFNLVNRLSVLENVLIGALGSTPFWRTCFSWFTREQKQRALQALTRVGMVHFAHQRVSTLSGGQQQRVAIARALMQQAKVILADEPIASLDPESARIVMDTLRDINQNDGITVVVTLHQVDYALRYCERIVALRQGHVF	PHNC_ECOLI	F1
C6ED26_ECOBD	MNQPLLSVNNLTHLYAPGKGFSDVSFDLWPGEVLGIVGESGSGKTTLLKSISARLTPQQGEIHYENRSLYAMSEADRRRLLRTEWGVVHQHPLDGLRRQVSAGGNIGERLMATGARHYGDIRATAQKWLEEVEIPANRIDDLPTTFSGGMQQRLQIARNLVTHPKLVFMDEPTGGLDVSVQARLLDLLRGLVVELNLAVVIVTHDLGVARLLADRLLVMKQGQVVESGLTDR	PHNK_ECOLI	F1
C6ED27_ECOBD	MINVQNVSKTFILHQQNGVRLPVLNRASLTVNAGECVVLHGHSGSGKSTLLRSLYANYLPDEGQIQIKHGDEWVDLVTAPARKVVEIRKTTVGWVSQFLRVIPRISALEVVMQPLLDTGVPREACAAKAARLLTRLNVPERLWHLAPSTFSGGEQQRVNIARGFIVDYPILLLDEPTASLDAKNSAAVVELIREAKTRGAAIVGIFHDEAVRNDVADRLHPMGASS	PHNL_ECOLI	F1
C6EEZ9_ECOBD	MAALTASCIDLNIQGNGAYSVLKQLATIALQNGFITDSHQFLQTLLLREKMHSTGFGSGVAVPHGKSACVKQPFVLFARKAQAIDWKASDGEDVNCWICLGVPQSGEEDQVKIIGTLCRKIIHKEFIHQLQQGDTDQVLALLNQTLSS	PTFA_ECOLI	F1
C6EE59_ECOBD	MTKIIAVTACPSGVAHTYMAAEALESAAKAKGWEVKVETQGSIGLENELTAEDVASADMVILTKDIGIKFEERFAGKTIVRVNISDAVKRADAIMSKIEAHLAQTA	PTFB2_ECOLI	F1
C6EE56_ECOBD	MAYLVAVTACVSGVAHTYMAAERLEKLCLLEKWGVSIETQGALGTENRLADEDIRRADVALLITDIELAGAERFEHCRYVQCSIYAFLREPQRVMSAVRKVLSAPQQTHLILE	PTFB3_ECOLI	F1
C6EE61_ECOBD	MALIVEFICELPNGVHARPASHVETLCNTFSSQIEWHNLRTDRKGNAKSALALIGTDTLVGDNCQLLISGADEQEAHQRLSQWLRDEFPHCDAPLAEVKSDELEPLPVSLTNLNPQIIRARTVCSGSAGGILTPISSLDLNALSNLPAAKGVDAEQSALENGLTLVLKNIEFRLLDSDGATSAILEAHRSLAGDTSLREHLLAGVSAGLSCAEAIVASANHFCEEFARSSSS	PTFX2_ECOLI	F1
C6EJS7_ECOBD	MTVIYQTTITRIGASATDALSDQMLITFREGAPADLEEYCFIHCHGELKGALHPGLQFTLGQHRYPVTAVGSVAEDNLRELGHVTLRFDGLNEAEFPGTVHVAGPVPDDIAPGSVLKFESVKE	PTHA_ECOLI	F1
C6EIH6_ECOBD	MRLSDYFPESSISVIHSAKDWQEAIDFSMVSLLDKNYISENYIQAIKDSTINNGPYYILAPGVAMPHARPECGALKTGMSLTLLEQGVYFPGNDEPIKLLIGLSAADADSHIGAIQALSELLCEEEILEQLLTASSEKQLADIISRG	PTMA_ECOLI	F1
C6ECM2_ECOBD	MMDLDNIPDTQTEAEELEEVVMGLIINSGQARSLAYAALKQAKQGDFAAAKAMMDQSRMALNEAHLVQTKLIEGDAGEGKMKVSLVLVHAQDHLMTSMLARELITELIELHEKLKA	PTQA_ECOLI	F1
C6ECM0_ECOBD	MEKKHIYLFCSAGMSTSLLVSKMRAQAEKYEVPVIIEAFPETLAGEKGQNADVVLLGPQIAYMLPEIQRLLPNKPVEVIDSLLYGKVDGLGVLKAAVAAIKKAAAN	PTQB_ECOLI	F1
C6EG53_ECOBD	MEALLQLKGIDKAFPGVKALSGAALNVYPGRVMALVGENGAGKSTMMKVLTGIYARDAGTLLWLGKETTFTGPKSSQEAGIGIIHQELNLIPQLTIAENIFLGREFVNRFGKIDWKTMYAEADKLLAKLNLRFKSDKLVGDLSIGDQQMVEIAKVLSFESKVIIMDEPTDALTDTETESLFRVIRELKSQGRGIVYISHRMKEIFEICDDVTVFRDGQFIAEREVASLTEDS	RBSA_ECOLI	F1
C6EJT2_ECOBD	MAIDENKQKALAAALGQIEKQFGKGSIMRLGEDRSMDVETISTGSLSLDIALGAGGLPMGRIVEIYGPESSGKTTLTLQVIAAAQREGKTCAFIDAEHALDPIYARKLGVDIDNLLCSQPDTGEQALEICDALARSGAVDVIVVDSVAALTPKAEIEGEIGDSHMGLAARMMSQAMRKLAGNLKQSNTLLIFINQIRMKIGVMFGNPETTTGGNALKFYASVRLDIRRIGAV	RECA_ECOLI	F1
C6EDL8_ECOBD	MNAIWIAVAAVSLLGLAFGAILGYASRRFAVEDDPVVEKIDEILPQSQCGQCGYPGCRPYAEAISCNGEKINRCAPGGEAVMLKIAELLNVEPQPLDGEAQEITPARMVAVIDENNCIGCTKCIQACPVDAIVGATRAMHTVMSDLCTGCNLCVDPCPTHCISLQPVAETPDSWKWDLNTIPVRIIPVEHHA	RNFB_ECOLI	F1
C6EC54_ECOBD	MKKILVACGTGMSTSTMIAHKLQEFLTEQGISATTAQCCLNEIPLNCNGMDLIVTSMRTNSDYGIPTLNGAALLTGINDDALKQQIKALLTQ	SGCB_ECOLI	F1
C6ECS6_ECOBD	MALLPDKEKLLRNFLRCANWEEKYLYIIELGQRLPELRDEDRSPQNSIQGCQSQVWIVMRQNAQGIIELQGDSDAAIVKGLIAVVFILYDQMTPQDIVNFDVRPWFEKMALTQHLTPSRSQGLEAMIRAIRAKAAALS	SUFE_ECOLI	F1
C6EFX3_ECOBD	MADILLLDNIDSFTYNLADQLRSNGHNVVIYRNHIPAQTLIERLATMSNPVLMLSPGPGVPSEAGCMPELLTRLRGKLPIIGICLGHQAIVEAYGGYVGQAGEILHGKASSIEHDGQAMFAGLTNPLPVARYHSLVGSNIPAGLTINAHFNGMVMAVRHDADRVCGFQFHPESILTTQGARLLEQTLAWAQQKLEPANTLQPILEKLYQAQTLSQQESHQLFSAVVRGELKP	TRPG_ECOLI	F1
C6ECF4_ECOBD	MKLRDSLAENKSIRLQAEAETWQDAVKIGVDLLVAADVVEPRYYQAILDAVEQHGPYFVLAPGLAMPHGRPEEGVKKTGFALVTLKKPLEFNHEDNDPVDILITMAAVDANTHQEVGIMQIVNLFEDEENFDRLRACRTEQEVLDLIDRTNAAA	ULAC_ECOLI	F1
C6EB29_ECOBD	MCRHSLRSDGAGFYQLAGCEYSFSAIKIAAGGQFLPVICAMAMKSHFFLISVLNRRLTLTAVQGILGRFSLF	YAAY_ECOLI	F1
C6EAS8_ECOBD	MLGWVITCHDDRAQEMLDALEKKHGALLQCRAVNFWRGLSSNMLSRMMCDALHEADSGEGVIFLTDIAGAPPYRVASLLSHKHSRCEVISGVTLPLIEQMMACRETMTSSEFRERIVELGAPEVSSLWHQQQKNPPFVLKHNLYEY	YADI_ECOLI	F1
C6EGS3_ECOBD	MSHYHEQFLKQNPLAVLGVLRDLHKAAIPLRLSWNGGQLISKLLAITPDKLVLDFGSQAEDNIAVLKAQHITITAETQGAKVEFTVEQLQQSEYLQLPAFITVPPPTLWFVQRRRYFRISAPLHPPYFCQTKLADNSTLRFRLYDLSLGGMGALLETAKPAELQEGMRFAQIEVNMGQWGVFHFDAQLISISERKVIDGKNETITTPRLSFRFLNVSPTVERQLQRIIFSLE	YCGR_ECOLI	F1
C6EES2_ECOBD	MTYAVEFDNVSRLYGDVRAVDGVSIAIKDGEFFSMLGPSGSGKTTCLRLIAGFEQLSGGAISIFGKPASNLPPWERDVNTVFQDYALFPHMSILDNVAYGLMVKGVNKKQRHAMAQEALEKVALGFVHQRKPSQLSGGQRQRVAIARALVNEPRVLLLDEPLGALDLKLREQMQLELKKLQQSLGITFIFVTHDQGEALSMSDRVAVFNNGRIEQVDSPRDLYMRPRTPFVA	YDCT_ECOLI	F1
C6ECC0_ECOBD	MTTNQHQEILRTEGLSKFFPGVKALDNVDFSLRRGEIMALLGENGAGKSTLIKALTGVYHADRGTIWLEGQAISPKNTAHAQQLGIGTVYQEVNLLPNMSVADNLFIGREPKRFGLLRRKEMEKRATELMASYGFSLDVREPLNRFSVAMQQIVAICRAIDLSAKVLILDEPTASLDTQEVELLFDLMRQLRDRGVSLIFVTHFLDQVYQVSDRITVLRNGSFVGCRETCEL	YTFR_ECOLI	F1
C6EH91_ECOBD	MLSIILTGHGGFASGMEKAMKQILGEQSQFIAIDFPETSSTALLTSQLEEAIAQLDCEDGIVFLTDLLGGTPFRVASTLAMQKPGCEVITGTNLQLLLEMVLEREGLSGEEFRVQALECGHRGLTSLVDELGRCHEECPVEEGI	YADI_ECOLI	F1
C6ED87_ECOBD	MTKFSVVVAGGGSTFTPGIVLMLLANQDRFPLRALKFYDNDGARQEVIAEACKVILKEKAPDIAFSYTTDPEVAFSDVDFVMAHIRVGKYPMRELDEKIPLRHGVVGQETCGPGGIAYGMRSIGGVLELVDYMEKYSPNAWMLNYSNPAAIVAEATRRLRPNAKILNICDMPIGIESRMAQIVGLQDRKQMRVRYYGLNHFGWWTSIEDLQGNDLMPQLRQYVSKHGYVPPQ	GLVG_ECOLI	F1
C6EGJ5_ECOBD	MTKHARFFLLPSFILISAALIAGCNDKGEEKAHVGEPQVTVHIVKTAPLEVKTELPGRTNAYRIAEVRPQVSGIVLNRNFTEGSDVQAGQSLYQIDPATYQANYDSAKGELAKSEAAAAIAHLTVKRYVPLVGTKYISQQEYDQAIADARQADAAVIAAKATVESARINLAYTKVTAPISGRIGKSTVTEGALVTNGQTTELATVQQLDPIYVDVTQSSNDFMRLKQSVEQG	ACRE_ECOLI	E
C6E9Y5_ECOBD	MEISFTRVALLAAALFFVGCDQKPQPAKTHATEVTVLEGKTMGTFWRASIPGIDAKRSAELKEKIQTQLDADDQLLSTYKKDSALMRFNDSQSLSPWPVSEAMADIVTTSLRIGAKTDGAMDITVGPLVNLWGFGPEQQPVQIPSQEQIDAMKAKTGLQHLTVINQSHQQYLQKDLPDLYVDLSTVGEGYAADHLARLMEQEGISRYLVSVGGALNSRGMNGEGLPWRVAIQ	APBE_ECOLI	E
C6ECK6_ECOBD	MEKRTGCDQKENAAAKVEYDGLSNSQPLRVDANNHTVTMLVQINGRFLTDDTRHGIVFKDGSNGHKSLFMAYATPKAFYEALKEAGGTPGENMTMDNKETTHVTGSKLDISVNWQGAAKAYSFDEVIVDSNGKKLDMRFGGNLTAAEEKKTGCLVCLDSCPVGIVSNATYTYGAVEKRGEVKFKGNASVLPADNTLATVTFKITE	YDJY_ECOLI	E
C6EK00_ECOBD	MFFGGHVLRILFVCSLLLLSGCSHMANDSWSGQDKAQHFIASAMLSAAGNEYSQHQGMNRDRSAMFGLMFSVSLGASKELWDSRPEGSGWSWKDLAWDVAGASTGYTVWQLTRH	YFIM_ECOLI	E
C6EEG5_ECOBD	MKMVSRITAIGLAGVAICYLGLSGYVWYHDNKRSKQADVQASAVSENNKVLGFLREKGCDYCHTPSAELPAYYYIPGAKQLMDYDIKLGYKSFNLEAVRAALLADKPVSQSDLNKIEWVMQYETMPPTRYTALHWAGKVSDEERAEILAWIAKQRAEYYASNDTAPEHRNEPVQPIPQKLPTDAQKVALGFALYHDPRLSADSTISCAHCHALNAGGVDGRKTSIGVGGAVG	YHJA_ECOLI	E
C6EF03_ECOBD	MKRNLLSSAIIVAIMSLGLTGCDDKKAETETLPPANSQPAAPAPEAKPTEAPVAKAEAKPETPAQPVVDEQAVFDEKMDVYIKCYNKLQIPVQRSLARYADWLKDFKQGPTGEERTVYGIYGISESNLAECEKGVKSAVALTPALQPIDGVAVSYIDAAVALGNTINEMDKYYTQENYKDDAFAKGKTLHQTFLKNLEAFEPVAESYHAAIQEINDKRQLAELKNIEEREGK	YIIG_ECOLI	E
C6EDZ5_ECOBD	MKKRHLLSLLALGISMACYGETYPAPIGPSQSDFGGVGLLQTPTARMAREGELSLNYRDNDQYRYYSASVQLFPWLETTLRYTDVRTRQYSSVEAFSGDQTYKDKAFDLKLRLWEESYWLPQVAVGARDIGGTGLFDAEYLVASKAWGPFDFTLGLGWGYLGTSGNVKNPLCSASDKYCYRDNSYKQAGSIDGSQMFHGPASLFGGVEYQTPWQPLRLKLEYEGNNYQQDFA	YJBH_ECOLI	E
C6EEK8_ECOBD	MASQHINIHNSGVMSGNVTTAGDMNVMPGGALRVAKTTISGNLENGGTVQMNSEGGKPGNVLTVNGNYTGNNGLMTFNATLGGDNSPTDKMNVKGDTQGNTRVRVDNIGGVGAQTVNGIELIEVGGNSAGNFALTTGTVEAGAYVYTLAKGKGNDEKNWYLTSKWDGVTPADTPDPINNPPVVDPEGPSVYRPEAGSYISNIAAANSLFSHRLHDRLGEPQYTDSLHSQGSA	YDEK_ECOLI	E
C6EGM0_ECOBD	MGIFSIANQHIRFAVKLATAIVLALFVGFHFQLETPRWAVLTAAIVAAGPAFAAGGEPYSGAIRYRGFLRIIGTFIGCIAGLVIIIAMIRAPLLMILVCCIWAGFCTWISSLVRIENSYAWGLAGYTALIIVITIQPEPLLTPQFAVERCSEIVIGIVCAIMADLLFSPRSIKQEVDRELESLLVAQYQLMQLCIKHGDGEVVDKAWGDLVRRTTALQGMRSNLNMESSRWA	AAEB_ECOLI	B
C6EGL8_ECOBD	MSLFPVIVVFGLSFPPIFFELLLSLAIFWLVRRVLVPTGIYDFVWHPALFNTALYCCLFYLISRLFV	AAEX_ECOLI	B
C6EFP7_ECOBD	MSMSSIPSSSQSGKLYGWVERIGNKVPHPFLLFIYLIIVLMVTTAILSAFGVSAKNPTDGTPVVVKNLLSVEGLHWFLPNVIKNFSGFAPLGAILALVLGAGLAERVGLLPALMVKMASHVNARYASYMVLFIAFFSHISSDAALVIMPPMGALIFLAVGRHPVAGLLAAIAGVGCGFTANLLIVTTDVLLSGISTEAAAAFNPQMHVSVIDNWYFMASSVVVLTIVGGLIT	ABGT_ECOLI	B
C6EJM3_ECOBD	MPVLQWGMLCVLSLLLSIGFLAVHLPAALLLGPMIAGIIFSMRGITLQLPRSAFLAAQAILGCMIAQNLTGSILTTLAANWPIVLAILLVTLLSSAIVGWLLVRYSSLPGNTGAWGSSPGGAAAMVAMAQDYGADIRLVAFMQYLRVLFVAGAAVLVTRMMLGDNAEAVNQQIVWFPPVSINLLLTILLAVVAGTAGCMLRLPSGTMLIPMLAGAVLQSGQLITIELPEWLL	ABRB_ECOLI	B
C6EGJ4_ECOBD	MANFFIRRPIFAWVLAIILMMAGALAILQLPVAQYPTIAPPAVSVSANYPGADAQTVQDTVTQVIEQNMNGIDNLMYMSSTSDSAGSVTITLTFQSGTDPDIAQVQVQNKLQLATPLLPQEVQQQGISVEKSSSSYLMVAGFVSDNPDITQDDISDYVASNVKDTLSRLNGVGDVQLFGAQYAMRIWLDADLLNKYKLTPVDVINQLKVQNDQIAAGQLGGTPALPGQQLNA	ACRF_ECOLI	B
C6EDA4_ECOBD	MNNSINHKFHHISRAEYQELLAVSRGDAVADYIIDNVSILDLINGGEISGPIVIKGRYIAGVGAEYTDAPALQRIDARGATAVPGFIDAHLHIESSMMTPVTFETATLPRGLTTVICDPHEIVNVMGEAGFAWFARCAEQARQNQYLQVSSCVPALEGCDVNGASFTLEQMLAWRDHPQVTGLAEMMDYPGVISGQNALLDKLDAFRHLTLDGHCPGLGGKELNAYITAGIE	ADEC_ECOLI	B
C6ED09_ECOBD	MSSDADAHKVGLIPVTLMVSGNIMGSGVFLLPANLASTGGIAIYGWLVTIIGALGLSMVYAKMSFLDPSPGGSYAYARRCFGPFLGYQTNVLYWLACWIGNIAMVVIGVGYLSYFFPILKDPLVLTITCVVVLWIFVLLNIVGPKMITRVQAVATVLALIPIVGIAVFGWFWFRGETYMAAWNVSGLGTFGAIQSTLNVTLWSFIGVESASVAAGVVKNPKRNVPIATIGGV	ADIC_ECOLI	B
C6ELK2_ECOBD	MFPKIMNDENFFKKAAAHGEEPPLTPQNEHQRSGLRFARRVRLPRAVGLAGMFLPIASTLVSHPPPGWWWLVLVGWAFVWPHLAWQIASRAVDPLSREIYNLKTDAVLAGMWVGVMGVNVLPSTAMLMIMCLNLMGAGGPRLFVAGLVLMVVSCLVTLELTGITVSFNSAPLEWWLSLPIIVIYPLLFGWVSYQTATKLAEHKRRLQVMSTRDGMTGVYNRRHWETMLRNEF	ADRA_ECOLI	B
C6EC16_ECOBD	MQKAQRIIKTYRRNRMIVCTICALVTLASTLSVRFISQRNLNQQRVVQFANHAVEELDKVLLPLQAGSEVLLPLIGLPCSVAHLPLRKQAAKLQTVRSIGLVQDGTLYCSSIFGYRNVPVVDILAELPAPQPLLRLTIDRALIKGSPVLIQWTPAAGSSNAGVMEMINIDLLTAMLLEPQLPQISSASLTVDKRHLLYGNGLVDSLPQPEDNENYQVSSQRFPFTINVNGPG	ADRB_ECOLI	B
C6EHS4_ECOBD	MSSHPYVTQQNTPLADDTTLMSTTDLQSYITHANDTFVQVSGYTLQELQGQPHNMVRHPDMPKAAFADMWFTLKKGEPWSGIVKNRRKNGDHYWVRANAVPMVREGKISGYMSIRTRATDEEIAAVEPLYKALNAGRTSKRIHKGLVVRKGWLGKLPSLPLRWRARGVMTLMFILLAAMLWFVAAPVVTYILCALVVLLASACFEWQIVRPIENVAHQALKVATGERNSVEH	AER_ECOLI	B
C6EH84_ECOBD	MQTLQQVENYTALSERASEYLLAVIRSKPDAVICLATGATPLLTYHYLVEKIHQQQVDVSQLTFVKLDEWVDLPLTMPGTCETFLQQHIVQPLGLREDQLISFRSEEINETECERVTNLIARKGGLDLCVLGLGKNGHLGLNEPGESLQPACHISQLDARTQQHEMLKTAGRPVTRGITLGLKDILNAREVLLLVTGEGKQDATDRFLTAKVSTAIPASFLWLHSNFICLIN	AGAI_ECOLI	B
C6E9Y7_ECOBD	MLDLFADGEPWQEPLAAGAVILRRFAFNAAEQLIRDINDVASQSPFRQMVTPGGYTMSVAMTNCGHLGWTSHRQGYLYSPIDPQTNKPWPAMPQSFHNLCQRAATAAGYPDFQPDACLINRYAPGAKLSLHQDKDEPDLRAPIVSVSLGLPAIFQFGGLKRNDPLKRLLLEHGDVVVWGGESRLFYHGIQPLKAGFHPLTTDCRYNLTFRQAGKKE	ALKB_ECOLI	B
C6EKV5_ECOBD	MEHQRKLFQQRGYSEDLLPKTQSQRTWKTFNYFTLWMGSVHNVPNYVMVGGFFILGLSTFSIMLAIILSAFFIAAVMVLNGAAGSKYGVPFAMILRASYGVRGALFPGLLRGGIAAIMWFGLQCYAGSLACLILIGKIWPGFLTLGGDFTLLGLSLPGLITFLIFWLVNVGIGFGGGKVLNKFTAILNPCIYIVFGGMAIWAISLVGIGPIFDYIPSGIQKAENGGFLFLVV	ALLP_ECOLI	B
C6ED37_ECOBD	MGFTTRVKSEASEKKPFNFALFWDKYGTFFILAIIVAIFGSLSPEYFLTTNNITQIFVQSSVTVLIGMGEFFAILVAGIDLSVGAILALSGMVTAKLMLAGVDPFLAAMIGGVLVGGALGAINGCLVNWTGLHPFIITLGTNAIFRGITLVISDANSVYGFSFDFVNFFAASVIGIPVPVIFSLIVALILWFLTTRMRLGRNIYALGGNKNSAFYSGIDVKFHILVVFIISG	ALSC_ECOLI	B
C6EL33_ECOBD	MSSQYLRIFQQPRSAILLILGFASGLPLALTSGTLQAWMTVENIDLKTIGFFSLVGQAYVFKFLWSPLMDRYTPPFFGRRRGWLLATQILLLVAIAAMGFLEPGTQLRRMAALAVVIAFCSASQDIVFDAWKTDVLPAEERGAGAAISVLGYRLGMLVSGGLALWLADKWLGWQGMYWLMAALLIPCIIATLLAPEPTDTIPVPKTLEQAVVAPLRDFFGRNNAWLILLLIV	AMPG_ECOLI	B
C6EL12_ECOBD	MKIATIKTGLASLAMLPGLVMAAPAVADKADNAFMMICTALVLFMTIPGIALFYGGLIRGKNVLSMLTQVTVTFALVCILWVVYGYSLAFGEGNNFFGNINWLMLKNIELTAVMGSIYQYIHVAFQGSFACITVGLIVGALAERIRFSAVLIFVVVWLTLSYIPIAHMVWGGGLLASHGALDFAGGTVVHINAAIAGLVGAYLIGKRVGFGKEAFKPHNLPMVFTGTAILYI	AMTB_ECOLI	B
C6EER0_ECOBD	MSKHDTDTSDQHAAKRRWLNAHEEGYHKAMGNRQVQMIAIGGAIGTGLFLGAGARLQMAGPALALVYLICGLFSFFILRALGELVLHRPSSGSFVSYAREFLGEKAAYVAGWMYFINWAMTGIVDITAVALYMHYWGAFGGVPQWVFALAALTIVGTMNMIGVKWFAEMEFWFALIKVLAIVTFLVVGTVFLGSGQPLDGNTTGFHLITDNGGFFPHGLLPALVLIQGVVFA	ANSP_ECOLI	B
C6EHM9_ECOBD	MFDYETLRFIWWLLIGVILVVFMISDGFDMGIGCLLPLVARNDDERRIVINSVGAHWEGNQVWLILAGGALFAAWPRVYAAAFSGFYVAMILVLCSLFFRPLAFDYRGKIADARWRKMWDAGLVIGSLVPPVVFGIAFGNLLLGVPFAFTPQLRVEYLGSFWQLLTPFPLLCGLLSLGMVILQGGVWLQLKTVGVIHLRSQLATKRAALLVMLCFLLAGYWLWVGIDGFVLL	APPB_ECOLI	B
C6EIA6_ECOBD	MFRKLAAECFGTFWLVFGGCGSAVLAAGFPELGIGFAGVALAFGLTVLTMAFAVGHISGGHFNPAVTIGLWAGGRFPAKEVVGYVIAQVVGGIVAAALLYLIASGKTGFDAAASGFASNGYGEHSPGGYSMLSALVVELVLSAGFLLVIHGATDKFAPAGFAPIAIGLALTLIHLISIPVTNTSVNPARSTAVAIFQGGWALEQLWFFWVVPIVGGIIGGLIYRTLLEKRD	AQPZ_ECOLI	B
C6EJ27_ECOBD	MVTINTESALTPRSLRDTRRMNMFVSVAAAVAGLLFGLDIGVIAGALPFITDHFVLTSRLQEWVVSSMMLGAAIGALFNGWLSFRLGRKYSLMAGAILFVLGSIGSAFATSVEMLIAARVVLGIAVGIASYTAPLYLSEMASENVRGKMISMYQLMVTLGIVLAFLSDTAFSYSGNWRAMLGVLALPAVLLIILVVFLPNSPRWLAEKGRHIEAEEVLRMLRDTSEKAREEL	ARAE_ECOLI	B
C6ELI8_ECOBD	MALLVLILQAITLLATVIGSRSGGCDGGMKKVILSLALGTFGLGMAEFGIMGVLTELAHNVGISIPAAGHMISYYALGVVVGAPIIALFSSRYSLKHILLFLVALCVIGNAMFTLSSSYLMLAIGRLVSGFPHGAFFGVGAIVLSKIIKPGKVTAAVAGMVSGMTVANLLGIPLGTYLSQEFSWRYTFLLIAVFNIAVMASVYFWVPDICDEAKGNLREQFHFLRSPAPWLI	ARAJ_ECOLI	B
C6EDP3_ECOBD	MEKKLGLSALTALVLSSMLGAGVFSLPQNMAAVASPAALLIGWGITGAGILLLAFAMLILTRIRPELDGGIFTYAREGFGELIGFCSAWGYWLCAVIANVSYLVIVFSALSFFTDTPELRLFGDGNTWQSIVGASALLWIVHFLILRGVQTAASINLVATLAKLLPLGLFVVLAMMMFKLDTFKLDFTGLALGVPVWEQVKNTMLITLWVFIGVEGAVVVSARARNKRDVGK	ARCD_ECOLI	B
C6EII6_ECOBD	MFSYYFQGLALGAAMILPLGPQNAFVMNQGIRRQYHIMIALLCAISDLVLICAGIFGGSALLMQSPWLLALVTWGGVAFLLWYGFGAFKTAMSSNIELASAEVMKQGRWKIIATMLAVTWLNPHVYLDTFVVLGSLGGQLDVEPKRWFALGTISASFLWFFGLALLAAWLAPRLRTAKAQRIINLVVGCVMWFIALQLARDGIAHAQALFS	ARGO_ECOLI	B
C6E9U2_ECOBD	MIWLTLVFASLLSVAGQLCQKQATCFVAINKRRKHIVLWLGLALACLGLAMVLWLLVLQNVPVGIAYPMLSLNFVWVTLAAVKLWHEPVSPRHWCGVAFIIGGIVILGSTV	ARNE_ECOLI	B
C6E9U1_ECOBD	MGLMWGLFSVIIASVAQLSLGFAASHLPPMTHLWDFIAALLAFGLDARILLLGLLGYLLSVFCWYKTLHKLALSKAYALLSMSYVLVWIASMVLPGWEGTFSLKALLGVACIMSGLMLIFLPTTKQRY	ARNF_ECOLI	B
C6EEI2_ECOBD	MLLAGAIFVLTIVLVIWQPKGLGIGWSATLGAVLALVTGVVHPGDIPVVWNIVWNATAAFIAVIIISLLLDESGFFEWAALHVSRWGNGRGRLLFTWIVLLGAAVAALFANDGAALILTPIVIAMLLALGFSKGTTLAFVMAAGFIADTASLPLIVSNLVNIVSADFFGLGFREYASVMVPVDIAAIVATLVMLHLYFRKDIPQNYDMALLKSPAEAIKDPATFKTGWVVLL	ARSB_ECOLI	B
C6EJN6_ECOBD	MAAQGFLLIATFLLVLMVLARPLGSGLARLINDIPLPGTTGVERVLFRALGVSDREMNWKQYLCAILGLNMLGLAVLFFMLLGQHYLPLNPQQLPGLSWDLALNTAVSFVTNTNWQSYSGETTLSYFSQMAGLTVQNFLSAASGIAVIFALIRAFTRQSMSTLGNAWVDLLRITLWVLVPVALLIALFFIQQGALQNFLPYQAVNTVEGAQQLLPMGPVASQEAIKMLGTNG	ATKA_ECOLI	B
C6E9X7_ECOBD	MIGRISRFMTRFVSRWLPDPLIFAMLLTLLTFVIALWLTPQTPISMVKMWGDGFWNLLAFGMQMALIIVTGHALASSAPVKSLLRTAASAAKTPVQGVMLVTFFGSVACVINWGFGLVVGAMFAREVARRVPGSDYPLLIACAYIGFLTWGGGFSGSMPLLAATPGNPVEHIAGLIPVGDTLFSGFNIFITVALIVVMPFITRMMMPKPSDVVSIDPKLLMEEADFQKQLPK	ATOE_ECOLI	B
C6E9Y1_ECOBD	MHYMKWIYPRRLRNQMILMAILMVIVPTLTIGYIVETEGRSAVLSEKEKKLSAVVNLLNQALGNRYDLYIDLPREERIRALNAELAPITENITHAFPGIGAGYYNKTLDAIITYAPSALYQNNVGVTIAADHPGREVMRTNTPLVYSGRQVRGDILNSMIPIERNGEILGYIWANELTEDIRRQAWKMDVRIIIVLTAGLLISLLLIVLFSRRLSANIDIITDGLSTLAQNI	ATOS_ECOLI	B
C6EG64_ECOBD	MSVSLVSRNVARKLLLVQLLVVIASGLLFSLKDPFWGVSAISGGLAVFLPNVLFMIFAWRHQAHTPAKGRVAWTFAFGEAFKVLAMLVLLVVALAVLKAVFLPLIVTWVLVLVVQILAPAVINNKG	ATPZ_ECOLI	B
C6EEF0_ECOBD	MSILTRWLLIPPVNARLIGRYRDYRRHGASAFSATLGCFWMILAWIFIPLEHPRWQRIRAEHKNLYPHINASRPRPLDPVRYLIQTCWLLIGASRKETPKPRRRAFSGLQNIRGRYHQWMNELPERVSHKTQHLDEKKELGHLSAGARRLILGIIVTFSLILALICVTQPFNPLAQFIFLMLLWGVALIVRRMPGRFSALMLIVLSLTVSCRYIWWRYTSTLNWDDPVSLVC	BCSA_ECOLI	B
C6EJ07_ECOBD	MAHRPRWTLSQVTELFEKPLLDLLFEAQQVHRQHFDPRQVQVSTLLSIKTGACPEDCKYCPQSSRYKTGLEAERLMEVEQVLESARKAKAAGSTRFCMGAAWKNPHERDMPYLEQMVQGVKAMGLEACMTLGTLSESQAQRLANAGLDYYNHNLDTSPEFYGNIITTRTYQERLDTLEKVRDAGIKVCSGGIVGLGETVKDRAGLLLQLANLPTPPESVPINMLVKVKGTPL	BIOB_ECOLI	B
C6EDQ5_ECOBD	MLKRFFITGTDTSVGKTVVSRALLQALASQGKTVAGYKPVAKGSKETPEGLRNKDALVLQSVSTIELPYEAVNPIALSEEESSVAHSCPINYTLISNGLANLTEKVDHVVVEGTGGWRSLMNDLRPLSEWVVQEQLPVLMVVGIQEGCINHALLTAQAIANDGLPLIGWVANRINPGLAHYAEIIDVLGKKLPAPLIGELPYLPRAEQRELGQYIRLAMLRSVLAVDRVTV	BIOD2_ECOLI	B
C6EDM2_ECOBD	MLELLLLSNIYPLKLMDQSREMWAVMNRLIELTGWIVLVVSVILLGVASHIDNYQPPEQSASVQHK	BLR_ECOLI	B
C6ECP6_ECOBD	MLTLARQQQRQNIRWLLCLSVLMLLALLLSLCAGEQWISPGDWFTPRGELFVWQIRLPRTLAVLLVGAALAISGAVMQALFENPLAEPGLLGVSNGAGVGLIAAVLLGQGQLPNWALGLCAIAGALIITLILLRFARRHLSTSRLLLAGVALGIICSALMTWAIYFSTSVDLRQLMYWMMGGFGGVDWRQSWLMLALIPVLLWICCQSRPMNMLALGEISARQLGLPLWFWR	BTUC_ECOLI	B
C6EEU4_ECOBD	MENKYSRLQISIHWLVFLLVIAAYCAMEFRGFFPRSDRPLINMIHVSCGISILVLMVVRLLLRLKYPTPPIIPKPKPMMTGLAHLGHLVIYLLFIALPVIGLVMMYNRGNPWFAFGLTMPYASEANFERVDSLKSWHETLANLGYFVIGLHAAAALAHHYFWKDNTLLRMMPRKRS	C561_ECOLI	B
C6ECZ2_ECOBD	MSSAKKIGLFACTGVVAGNMMGSGIALLPANLASIGGIAIWGWIISIIGAMSLAYVYARLATKNPQQGGPIAYAGEISPAFGFQTGVLYYHANWIGNLAIGITAVSYLSTFFPVLNDPVPAGIACIAIVWVFTFVNMLGGTWVSRLTTIGLVLVLIPVVMTAIVGWHWFDAATYAANWNTADTTDGHAIIKSILLCLWAFVGVESAAVSTGMVKNPKRTVPLATMLGTGLAG	CADB_ECOLI	B
C6EB13_ECOBD	MKNEKRKTGIEPKVFFPPLIIVGILCWLTVRDLDAANVVINAVFSYVTNVWGWAFEWYMVVMLFGWFWLVFGPYAKKRLGNEPPEFSTASWIFMMFASCTSAAVLFWGSIEIYYYISTPPFGLEPNSTGAKELGLAYSLFHWGPLPWATYSFLSVAFAYFFFVRKMEVIRPSSTLVPLVGEKHVKGLFGTIVDNFYLVALIFAMGTSLGLATPLVTECMQWLFGIPHTLQLD	CAIT_ECOLI	B
C6EG87_ECOBD	MSVSRRVIHHGLYFAVLGPLIGVLFLVLYIFFAKEPLVLLVIIQVLPLFLLLSITTGAIPALLTGVMVACLPEKIGSQKNYRCLAGGIGGVVITEIYCAVIVHIKGMASSELFENILSGDSLVVRIIPALLAGVVMSRIITRLPGLDISCPETDSLS	CBRB_ECOLI	B
C6EA00_ECOBD	MMFWRIFRLELRVAFRHSAEIANPLWFFLIVITLFPLSIGPEPQLLARIAPGIIWVAALLSSLLALERLFRDDLQDGSLEQLMLLPLPLPAVVLAKVMAHWMVTGLPLLILSPLVAMLLGMDVYGWQVMALTLLLGTPTLGFLGAPGVALTVGLKRGGVLLSILVLPLTIPLLIFATAAMDAASMHLPVDGYLAILGALLAGTATLSPFATAAALRISIQ	CCMB_ECOLI	B
C6EAB0_ECOBD	MLKYRLISAFVLIPVVIAALFLLPPVGFAIVTLVVCMLAAWEWGQLSGFTTRSQRVWLAVLCGLLLALMLFLLPEYHRNIHQPLVEISLWASLGWWIVALLLVLFYPGSAAIWRNSKTLRLIFGVLTIVPFFWGMLALRAWHYDENHYSGAIWLLYVMILVWGADSGAYMFGKLFGKHKLAPKVSPGKTWQGFIGGLATAAVISWGYGMWANLDVAPVTLLICSIVAALASV	CDSA_ECOLI	B
C6EK81_ECOBD	MSMPATSTKTTKLATSLIDEYALLGWRAMLTEVNLSPKPGLVDRINCGAHKDMALEDFHRSALAIQGWLPRFIEFGACSAEMAPEAVLHGLRPIGMACEGDMFRATAGVNTHKGSIFSLGLLCAAIGRLLQLNQPVTPTTVCSTAASFCRGLTDRELRTNNSQLTAGQRLYQQLGLTGARGEAEAGYPLVINHALPHYLTLLDQGLDPELALLDTLLLLMAINGDTNVASRG	CITG_ECOLI	B
C6EK82_ECOBD	MSLAKDNIWKLLAPLVVMGVMFLIPVPDGMPPQAWHYFAVFVAMIVGMILEPIPATAISFIAVTICVIGSNYLLFDAKELADPAFNAQKQALKWGLAGFSSTTVWLVFGAFIFALGYEVSGLGRRIALFLVKFMGKRTLTLGYAIVIIDILLAPFTPSNTARTGGTVFPVIKNLPPLFKSFPNDPSARRIGGYLMWMMVISTSLSSSMFVTGAAPNVLGLEFVSKIAGIQIS	CITT_ECOLI	B
C6EDQ6_ECOBD	MFRRLLIATVVGILAAFAVAGFRHAMLLLEWLFLNNDSGSLVNAATNLSPWRRLLTPALGGLAAGLLLMGWQKFTQQRPHAPTDYMEALQTDGQFDYAASLVKSLASLLVVTSGSAIGREGAMILLAALAASCFAQRFTPRQEWKLWIACGAAAGMAAAYRAPLAGSLFIAEVLFGTMMLASLGPVIISAVVALLVSNLINHSDALLYNVQLSVTVQARDYALIISTGVLAG	CLCB_ECOLI	B
C6EBH1_ECOBD	MLKSPLFWKMTTLFGAVLLLLIPIMLIRQVIVERADYRSDVEDAIRQSTSGPQKLVGPLIAIPVTELYTVQEEDKTVERKRSFIHFWLPESLMVDGNQNVEERKIGIYTGQVWHSDLTLKADFDVSRLSELNAPNIILGKPFIVISVGDARGIGVVKAPEVNGTALTIEPGTGLEQGGQGVHIPLPEGDWRKQNLKLNMALNLSGTGDLSVVPAGRNSEMTLTSNWPHPSFL	CRED_ECOLI	B
C6EKC6_ECOBD	MIEWIIRRSVANRFLVLMGALFLSIWGTWTIINTPVDALPDLSDVQVIIKTSYPGQAPQIVENQVTYPLTTTMLSVPGAKTVRGFSQFGDSYVYVIFEDGTDPYWARSRVLEYLNQVQGKLPAGVSAELGPDATGVGWIYEYALVDRSGKHDLADLRSLQDWFLKYELKTIPDVAEVASVGGVVKEYQVVIDPQRLAQYGISLAEVKSALDASNQEAGGSSIELAEAEYMVR	CUSA_ECOLI	B
C6ELE0_ECOBD	MVWIDYAIIAVIAFSSLVSLIRGFVREALSLVTWGCAFFVASHYYTYLSVWFTGFEDELVRNGIAIAVLFIATLIVGAIVNFVIGQLVEKTGLSGTDRVLGVCFGALRGVLIVAAILFFLDSFTGVSKSEDWSKSQLIPQFSFIIRWFFDYLQSSSSFLPRA	CVPA_ECOLI	B
C6EHN4_ECOBD	MQQKSDNVVSHYVFEAPVRIWHWLTVLCMAVLMVTGYFIGKPLPSVSGEATYLFYMGYIRLIHFSAGMVFTVVLLMRIYWAFVGNRYSRELFIVPVWRKSWWQGVWYEIRWYLFLAKRPSADIGHNPIAQAAMFGYFLMSVFMIITGFALYSEHSQYAIFAPFRYVVEFFYWTGGNSMDIHSWHRLGMWLIGAFVIGHVYMALREDIMSDDTVISTMVNGYRSHKFGKISNK	CYBH_ECOLI	B
C6ELN9_ECOBD	MLLVLVLIGLNMRPLLTSVGPLLPQLRQASGMSFSVAALLTALPVVTMGGLALAGSWLHQHVSERRSVAISLLLIAVGALMRELYPQSALLLSSALLGGVGIGIIQAVMPSVIKRRFQQRTPLVMGLWSAALMGGGGLGAAITPWLVQHSETWYQTLAWWALPAVVALFAWWWQSAREVASSHKTTTTPVRVVFTPRAWTLGVYFGLINGGYASLIAWLPAFYIEIGASAQY	CYNX_ECOLI	B
C6EL38_ECOBD	MMFKQYLQVTKPGIIFGNLISVIGGFLLASKGSIDYPLFIYTLVGVSLVVASGCVFNNYIDRDIDRKMERTKNRVLVKGLISPAVSLVYATLLGIAGFMLLWFGANPLACWLGVMGFVVYVGVYSLYMKRHSVYGTLIGSLSGAAPPVIGYCAVTGEFDSGAAILLAIFSLWQMPHSYAIAIFRFKDYQAANIPVLPVVKGISVAKNHITLYIIAFAVATLMLSLGGYAGYK	CYOE_ECOLI	B
C6EL53_ECOBD	MFAVSSRRVLPGFTLSLGTSLLFVCLILLLPLSALVMQLSEMSWAQYWEVITNPQVVAAYKVTLLSAFVASIFNGVFGLLMAWILTRYRFPGRTLLDALMDLPFALPTAVAGLTLASLFSVNGFYGEWLAKFDIKVTYTWLGIAVAMAFTSIPFVVRTVQPVLEELGPEYEEAAETLGATRWQSFCKVVLPELSPALVAGVALSFTRSLGEFGAVIFIAGNIAWKTEVTSLM	CYST_ECOLI	B
C6EL54_ECOBD	MAEVTQLKRYDARPINWGKWFLIGTGMLVSAFILLVPMIYIFVQAFSKGLMPVLQNLADPDMLHAIWLTVMIALIAVPVNLVFGILLAWLVTRFNFPGRQLLLTLLDIPFAVSPVVAGLVYLLFYGSNGPLGGWLDEHNLQIMFSWPGMVLVTIFVTCPFVVRELVPVMLSQGSQEDEAAILLGASGWQMFRRVTLPNIRWALLYGVVLTNARAIGEFGAVSVVSGSIRGET	CYSW_ECOLI	B
C6ED01_ECOBD	MLFTIQLIIILICLFYGARKGGIALGLLGGIGLVILVFVFHLQPGKPPVDVMLVIIAVVAASATLQASGGLDVMLQIAEKLLRRNPKYVSIVAPFVTCTLTILCGTGHVVYTILPIIYDVAIKNNIRPERPMAASSIGAQMGIIASPVSVAVVSLVAMLGNVTFDGRHLEFLDLLAITIPSTLIGILAIGIFSWFRGKDLDKDEEFQKFISVPENREYVYGDTATLLDKKLP	DCUB_ECOLI	B
C6EK71_ECOBD	MLTFIELLIGVVVIVGVARYIIKGYSATGVLFVGGLLLLIISAIMGHKVLPSSQASTGYSATDIVEYVKILLMSRGGDLGMMIMMLCGFAAYMTHIGANDMVVKLASKPLQYINSPYLLMIAAYFVACLMSLAVSSATGLGVLLMATLFPVMVNVGISRGAAAAICASPAAIILAPTSGDVVLAAQASEMSLIDFAFKTTLPISIAAIIGMAIAHFFWQRYLDKKEHISHEM	DCUC_ECOLI	B
C6EH05_ECOBD	MFGIIISVIVLITMGYLILKNYKPQVVLAAAGIFLMMCGVWLGFGGVLDPTKSSGYLIVDIYNEILRMLSNRIAGLGLSIMAVGGYARYMERIGASRAMVSLLSRPLKLIRSPYIILSATYVIGQIMAQFITSASGLGMLLMVTLFPTLVSLGVSRLSAVAVIATTMSIEWGILETNSIFAAQVAGMKIATYFFHYQLPVASCVIISVAISHFFVQRAFDKKDKNINHEQAE	DCUD_ECOLI	B
C6EL90_ECOBD	MFPQCKFSREFLHPRYWLTWFGLGVLWLWVQLPYPVLCFLGTRIGAMARPFLKRRESIARKNLELCFPQHSAEEREKMIAENFRSLGMALVETGMAWFWPDSRVRKWFDVEGLDNLKRAQMQNRGVMVVGVHFMSLELGGRVMGLCQPMMATYRPHNNQLMEWVQTRGRMRSNKAMIGRNNLRGIVGALKKGEAVWFAPDQDYGRKGSSFAPFFAVENVATTNGTYVLSRLS	DDG_ECOLI	B
C6EEN1_ECOBD	MTFWSILRQRCWGLVLVVAGVCVITFIISHLIPGDPARLLAGDRASDAIVENIRQQLGLDQPLYVQFYRYVSDLFHGDLGTSIRTGRPVLEELRIFFPATLELAFCALLLALLIGIPLGILSAVWRNRWLDHLVRIMAITGISTPAFWLGLGVIVLFYGHLQILPGGGRLDDWLDPPTHVTGFYLLDALLEGNGEVFFNALQHLILPALTLAFVHLGIVARQIRSAMLEQLS	DDPB_ECOLI	B
C6EEN2_ECOBD	MMLSEETSAVRPQKQTRFNGAKLVWMLKGSPLTVTGAVIIVLMLLMMIFSPWLATHDPNAIDLTARLLPPSAAHWFGTDEVGRDLFSRVLVGSQQSILAGLVVVAIAGMIGSLLGCLSGVLGGRADAIIMRIMDIMLSIPSLVLTMALAAALGPSLFNAMLAIAIVRIPFYVRLARGQALVVRQYTYVQAAKTFGASRWHLINWHILRNSLPPLIVQASLDIGSAILMAATL	DDPC_ECOLI	B
C6ED76_ECOBD	MTARYIAIDWGSTNLRAWLYQGDHCLESRQSEAGVTRLNGKSPAAVLAEVTTDWREENTPVVMAGMVGSNVGWKVAPYLSVPARFSSIGEQLTSVGDNIWIIPGLCVSHDDNHNVMRGEETQLIGARALAPSSLYVMPGTHCKWVQADSQQINDFRTVMTGELHHLLLNHSLIGAGLPPQENSADAFAAGLERGLNTPAILPQLFEVRASHVLGTLPREQVSEFLSGLLIGA	DGOK_ECOLI	B
C6ED79_ECOBD	MDIPVNAAKPGRRRYLTLVMIFITVVICYVDRANLAVASAHIQEEFGITKAEMGYVFSAFAWLYTLCQIPGGWFLDRVGSRVTYFIAIFGWSVATLFQGFATGLMSLIGLRAITGIFEAPAFPTNNRMVTSWFPEHERASAVGFYTSGQFVGLAFLTPLLIWIQEMLSWHWVFIVTGGIGIIWSLIWFKVYQPPRLTKGISKAELDYIRDGGGLVDGDAPVKKEARQPLTAK	DGOT_ECOLI	B
C6EDX6_ECOBD	MAFLTSSDKALWHLALPMIFSNITVPLLGLVDTAVIGHLDSPVYLGGVAVGATATSFLFMLLLFLRMSTTGLTAQAYGAKNPQALARALVQPLLLALGAGALIALLRTPIIDLALHIVGGSEAVLEQARRFLEIRWLSAPASLANLVLLGWLLGVQYARAPVILLVVGNILNIVLDVWLVMGLHMNVQGAALATVIAEYATLLIGLLMVRKILKLRGISGEMLKTAWRGNFR	DINF_ECOLI	B
C6EEI9_ECOBD	MNTTTPMGMLQQPRPFFMIFFVELWERFGYYGVQGVLAVFFVKQLGFSQEQAFVTFGAFAALVYGLISIGGYVGDHLLGTKRTIVLGALVLAIGYFMTGMSLLKPDLIFIALGTIAVGNGLFKANPASLLSKCYPPKDPRLDGAFTLFYMSINIGSLIALSLAPVIADRFGYSVTYNLCGAGLIIALLVYIACRGMVKDIGSEPDFKPMSFSKLLYVLLGSVVMIFVCAWLM	DTPB_ECOLI	B
C6EJM9_ECOBD	MNKHASQPRAIYYVVALQIWEYFSFYGMRALLILYLTNQLKYNDTHAYELFSAYCSLVYVTPILGGFLADKVLGNRMAVMLGALLMAIGHVVLGASEIHPSFLYLSLAIIVCGYGLFKSNVSCLLGELYEPTDPRRDGGFSLMYAAGNVGSIIAPIACGYAQEEYSWAMGFGLAAVGMIAGLVIFLCGNRHFTHTRGVNKKVLRATNFLLPNWGWLLVLLVATPALITVLFW	DTPD_ECOLI	B
C6EDV4_ECOBD	MSRKDGVLALLVVVVWGLNFVVIKVGLHNMPPLMLAGLRFMLVAFPAIFFVARPKVPLNLLLGYGLTISFAQFAFLFCAINFGMPAGLASLVLQAQAFFTIVLGAFTFGERLHGKQLAGIALAIFGVLVLIEDSLNGQHVAMLGFMLTLAAAFSWACGNIFNKKIMSHSTRPAVISLVIWSALIPIIPFFVASLILDGSASMIHSLVTIDMTTILSLMYLAFVATIVGYGIW	EAMA_ECOLI	B
C6EK08_ECOBD	MTPTLLSAFWTYTLITAMTPGPNNILALSSATSHGFRQSTRVLAGMSLGFLIVMLLCAGISFSLAVIDPAAVHLLSWAGAAYIVWLSWKIATSPTKEDGLQAKPISFWASFALQFVNVKIILYGVTALSTFVLPQTQALSWVVGVSVLLAMIGTFGNVCWALAGHLFQRLFRQYGRQLNIVLALLLVYCAVRIFY	EAMB_ECOLI	B
C6ED95_ECOBD	MKRQRNVNLLLMLVLLVAVGQMAQTIYIPAIADMARDLNVREGAVQSVMGAYLLTYGVSQLFYGPISDRVGRRPVILVGMSIFMLATLVAVTTSSLTVLIAASAMQGMGTGVGGVMARTLPRDLYERTQLRHANSLLNMGILVSPLLAPLIGGLLDTMWNWRACYLFLLVLCAGVTFSMARWMPETRPVDAPRTRLLTSYKTLFGNSGFNCYLLMLIGGLAGIAAFEACSGV	EMRD_ECOLI	B
C6ELA1_ECOBD	MAITKSTPAPLTGGTLWCVTIALSLATFMQMLDSTISNVAIPTISGFLGASTDEGTWVITSFGVANAIAIPVTGRLAQRIGELRLFLLSVTFFSLSSLMCSLSTNLDVLIFFRVVQGLMAGPLIPLSQSLLLRNYPPEKRTFALALWSMTVIIAPICGPILGGYICDNFSWGWIFLINVPMGIVVLTLCLTLLKGRETETSPVKMNLPGLTLLVLGVGGLQIMLDKGRDLDW	EMRY_ECOLI	B
C6EKA4_ECOBD	MNKQSWLLNLSLLKTHPAFRAVFLARFISIVSLGLLGVAVPVQIQMMTHSTWQVGLSVTLTGGAMFVGLMVGGVLADRYERKKVILLARGTCGIGFIGLCLNALLPEPSLLAIYLLGLWDGFFASLGVTALLAATPALVGRENLMQAGAITMLTVRLGSVISPMIGGLLLATGGVAWNYGLAAAGTFITLLPLLSLPALPPPPQPREHPLKSLLAGFRFLLASPLVGGIALL	ENTS_ECOLI	B
C6EED5_ECOBD	MRYIKSITQQKLSFLLAIYIGLFMNGAVFYRRFGSYAHDFTVWKGISAVVELAATVLVTFFLLRLLSLFGRRSWRILASLVVLFSAGASYYMTFLNVVIGYGIIASVMTTDIDLSKEVVGLNFILWLIAVSALPLILIWNNRCRYTLLRQLRTPGQRIRSLAVVVLAGIMVWAPIRLLDIQQKKVERATGVDLPSYGGVVANSYLPSNWLSALGLYAWARVDESSDNNSLLN	EPTB_ECOLI	B
C6EKR1_ECOBD	MGINEIIMYIMMFFMLIAAVDRILSQFGGSARFLGKFGKSIEGSGGQFEEGFMAMGALGLAMVGMTALAPVLAHVLGPVIIPVYEMLGANPSMFAGTLLACDMGGFFLAKELAGGDVAAWLYSGLILGSMMGPTIVFSIPVALGIIEPSDRRYLALGVLAGIVTIPIGCIAGGLVAMYSGVQINGQPVEFTFALILMNMIPVLIVAVLVALGLKFIPEKMINGFQIFAKFLV	EUTH_ECOLI	B
C6EL98_ECOBD	MKFLPYIFLLCCGLWSTISFADEDYIEYRGISSNNRVTLDPLRLSNKELRWLASKKNLVIAVHKSQTATLLHTDSQQRVRGINADYLNLLKRALNIKLTLREYADHQKAMDALAEGEVDIVLSHLVTSPPLNNDIAATKPLIITFPALVTTLHDSMRPLTSPKPVNIARVANYPPDEVIHQSFPKATIISFTNLYQALASVSAGHNDYFIGSNIITSSMISRYFTHSLNVVK	EVGS_ECOLI	B
C6EHY8_ECOBD	MAMHLNENLDDNGEMHDINVTPFIDVMLVLLIIFMVAAPLATVDVKVNLPASTSTPQPRPEKPVYLSVKADNSMFIGNDPVTDETMITALNALTEGKKDTTIFFRADKTVDYETLMKVMDTLHQAGYLKIGLVGEETAKAK	EXBD_ECOLI	B
C6EHQ1_ECOBD	MRKIKGLRWYMIALVTLGTVLGYLTRNTVAAAAPTLMEELNISTQQYSYIIAAYSAAYTVMQPVAGYVLDVLGTKIGYAMFAVLWAVFCGATALAGSWGGLAIARGAVGAAEAAMIPAGLKASSEWFPAKERSIAVGYFNVGSSIGAMIAPPLVVWAIVMHSWQMAFIISGALSFIWAMAWLIFYKHPRDQKHLTDEERDYIINGQEAQHQVSTAKKMSVGQILRNRQFWGI	EXUT_ECOLI	B
C6EL94_ECOBD	MSTPLQGIKVLDFTGVQSGPSCTQMLAWFGADVIKIERPGVGDVTRHQLRDIPDIDALYFTMLNSNKRSIELNTKTAEGKEVMEKLIREADILVENFHPGAIDHMGFTWEHIQEINPRLIFGSIKGFDECSPYVNVKAYENVAQAAGGAASTTGFWDGPPLVSAAALGDSNTGMHLLIGLLAALLHREKTGRGQRVTMSMQDAVLNLCRVKLRDQQRLDKLGYLEEYPQYPN	FCTA_ECOLI	B
C6EEP2_ECOBD	MAMETQDIIKRSATNSITPPSQVRDYKAEVAKLIDVSTCIGCKACQVACSEWNDIRDEVGHCVGVYDNPADLSAKSWTVMRFSETEQNGKLEWLIRKDGCMHCEDPGCLKACPSAGAIIQYANGIVDFQSENCIGCGYCIAGCPFNIPRLNKEDNRVYKCTLCVDRVSVGQEPACVKTCPTGAIHFGTKKEMLELAEQRVAKLKARGYEHAGVYNPEGVGGTHVMYVLHHAD	FDNH_ECOLI	B
C6EEP1_ECOBD	MSKSKMIVRTKFIDRACHWTVVICFFLVALSGISFFFPTLQWLTQTFGTPQMGRILHPFFGIAIFVALMFMFVRFVHHNIPDKKDIPWLLNIVEVLKGNEHKVADVGKYNAGQKMMFWSIMSMIFVLLVTGVIIWRPYFAQYFPMQVVRYSLLIHAAAGIILIHAILIHMYMAFWVKGSIKGMIEGKVSRRWAKKHHPRWYREIEKAEAKKESEEGI	FDNI_ECOLI	B
C6EC67_ECOBD	MTAIKHPVLLWGLPVAALIIIFWLSLFCYSAIPVSGADATRALLPGHTPTLPEALVQNLRLPRSLVAVLIGASLALAGTLLQTLTHNPMASPSLLGINSGAALAMALTSALSPTPIAGYSLSFIAACGGGVSWLLVMTAGGGFRHTHDRNKLILAGIALSAFCMGLTRITLLLAEDHAYGIFYWLAGGVSHARWQDVWQLLPVVVTAVPVVLLLANQLNLLNLSDSTAHTLG	FECC_ECOLI	B
C6EC64_ECOBD	MNPLLTDSRRQALRSASHWYAVLSGERVSPQQEARWQQWYEQDQDNQWAWQQVENLRNQLGGVPGDVASRALHDTRLTRRHVMKGLLLLLGAGGGWQLWQSETGEGLRADYRTAKGTVSRQQLEDGSLLTLNTQSAADVRFDAHQRTVRLWYGEIAITTAKDALQRPFRVLTRQGQLTALGTEFTVRQQDNFTQLDVQQHAVEVLLASAPAQKRIVNAGESLQFSASEFGAV	FECR_ECOLI	B
C6EKA8_ECOBD	MSSLNIKQGSDAHFPDYPLASPSNNEIDLLNLISVLWRAKKTVMAVVFAFACAGLLISFILPQKWTSAAVVTPPEPVQWQELEKTFTKLRVLDLDIKIDRTEAFNLFIKKFQSVSLLEEYLRSSPYVMDQLKEAKIDELDLHRAIVALSEKMKAVDDNASKKKDEPSLYTSWTLSFTAPTSEEAQTVLSGYIDYISTLVVKESLENVRNKLEIKTQFEKEKLAQDRIKTKNQ	FEPE_ECOLI	B
C6EKA6_ECOBD	MIYVSRRLLITCLLLISACVVAGIWGLRSGAVTLETSQVFAALRGDAPRSMTMVVTEWRLPRVLMALLIGAALGVSGAIFQSLMRNPLGSPDVMGFNTGAWSGVLVAMVLFGQDLTAIALSAMVGGIVTSLLVWLLAWRNGIDTFRLIIIGIGVRAMLVAFNTWLLLKASLETALTAGLWNAGSLNGLTWAKTSPSAPIIILMLIAATLLVRRMRLLEMGDDTACALGVSVE	FEPG_ECOLI	B
C6EAD1_ECOBD	MSKRIALFPALLLALLVIVATALTWMNFSQALPRSQWAQAAWSPDIDVIEQMIFHYSLLPRLAISLLVGAGLGLVGVLFQQVLRNPLAEPTTLGVATGAQLGITVTTLWAIPGAMASQFAALVGACVVGLIVFGVAWGKRLSPVTLILAGLVVSLYCGAINQLLVIFHHDQLQSMFLWSTGTLTQTDWGGVERLWPQLLGGVMLTLLLLRPLTLMGLDDGVARNLGLALSLA	FHUB_ECOLI	B
C6EBC8_ECOBD	MSAIQGIEGVISQLQATAMSARAQESLPQPTISFAGQLHAALDRISDTQTAARTQAEKFTLGEPGVALNDVMTDMQKASVSMQMGIQVRNKLVAAYQEVMSMQV	FLIE_ECOLI	B
C6EBC7_ECOBD	MNATAAQTKSLEWLNRLRANPKIPLIVAGSAAVAVMVALILWAKAPDYRTLFSNLSDQDGGAIVSQLTQMNIPYRFSEASGAIEVPADKVHELRLRLAQQGLPKGGAVGFELLDQEKFGISQFSEQVNYQRALEGELSRTIETIGPVKGARVHLAMPKPSLFVREQKSPSASVTVNLLPGRALDEGQISAIVHLVSSAVAGLPPGNVTLVDQGGHLLTQSNTSGRDLNDAQL	FLIF_ECOLI	B
C6EBB8_ECOBD	MNNHATVQSSAPVSAAPLLQVSGALIAIIALILAAAWLVKRLGFAPKRTGVNGLKISASASLGARERVVVVDVEDARLVLGVTAGQINLLHKLPPSAPTEEIPQTDFQSVMKNLLKRSGRS	FLIO_ECOLI	B
C6EBB7_ECOBD	MRRLLSVAPVLLWLITPLAFAQLPGITSQPLPGGGQSWSLPVQTLVFITSLTFIPAILLMMTSFTRIIIVFGLLRNALGTPSAPPNQVLLGLALFLTFFIMSPVIDKIYVDAYQPFSEEKISMQEALEKGAQPLREFMLRQTREADLGLFARLANTGPLQGPEAVPMRILLPAYVTSELKTAFQIGFTIFIPFLIIDLVIASVLMALGMMMVPPATIALPFKLMLFVLVDGW	FLIP_ECOLI	B
C6EBB6_ECOBD	MTPESVMMMGTEAMKVALALAAPLLLVALVTGLIISILQAATQINEMTLSFIPKIIAVFIAIIIAGPWMLNLLLDYVRTLFTNLPYIIG	FLIQ_ECOLI	B
C6EBB5_ECOBD	MLQVTSEQWLSWLNLYFWPLLRVLALISTAPILSERSVPKRVKLGLAMMITFAIAPSLPANDVPVFSFFALWLAVQQILIGIALGFTMQFAFAAVRTAGEIIGLQMGLSFATFVDPASHLNMPVLARIMDMLALLLFLTFNGHLWLISLLVDTFHTLPIGGEPLNSNAFLALTKAGSLIFLNGLMLALPLITLLLTLNLALGLLNRMAPQLSIFVIGFPLTLTVGISLMAAL	FLIR_ECOLI	B
C6EKL9_ECOBD	MRNKLSFDLQLSARKAAIAERIAAHKIARSKVSVFLMAMSAGVFMAIGFTFYLSVIADAPSSQALTHLVGGLCFALGFILLAVCGTSLFTSSVMTVMAKSRGVISWRTWLINALLVACGNLAGIACFSLLIWFSGLVMSENAMWGVAVLHCAEGKMHHTFTESVSLGIMCNLMVCLALWMSYCGRSLCDKIVAMILPITLFVASGFEHCIANLFVIPFAIAIRHFAPPPFWQ	FOCB_ECOLI	B
C6EFK6_ECOBD	MGSQELQRKLGFWAVLAIAVGTTVGSGIFVSVGEVAKAAGTPWLTVLAFVIGGLIVIPQMCVYAELSTAYPENGADYVYLKNAGSRPLAFLSGWASFWANDAPSLSIMALAIVSNLGFLTPIDPLLGKFIAAGLIIAFMLLHLRSVEGGAAFQTLITIAKIIPFTIVIGLGIFWFKAENFAAPTTTAIGATGSFMALLAGISATSWSYTGMASICYMTGEIKNPGKTMPRAL	FRLA_ECOLI	B
C6EJW2_ECOBD	MGQSSQPHELGGGLKSRHVTMLSIAGVIGASLFVGSSVAIAEAGPAVLLAYLFAGLLVVMIMRMLAEMAVATPDTGSFSTYADKAIGRWAGYTIGWLYWWFWVLVIPLEANIAAMILHSWVPGIPIWLFSLVITLALTGSNLLSVKNYGEFEFWLALCKVIAILAFIFLGAVAISGFYPYADVSGISRLWDSGGFMPNGFGAVLSAMLITMFSFMGAEIVTIAAAESDTPEK	GABP_ECOLI	B
C6EEM5_ECOBD	MATSVQTGKAKQLTLLGFFAITASMVMAVYEYPTFATSGFSLVFFLLLGGILWFIPVGLCAAEMATVDGWEEGGVFAWVSNTLGPRWGFAAISFGYLQIAIGFIPMLYFVLGALSYILKWPALNEDPITKTIAALIILWALALTQFGGTKYTARIAKVGFFAGILLPAFILIALAAIYLHSGAPVAIEMDSKTFFPDFSKVGTLVVFVAFILSYMGVEASATHVNEMSNPGR	GADC_ECOLI	B
C6EH99_ECOBD	MILDTVDEKKKGVHTRYLILLIIFIVTAVNYADRATLSIAGTEVAKELQLSAVSMGYIFSAFGWAYLLMQIPGGWLLDKFGSKKVYTYSLFFWSLFTFLQGFVDMFPLAWAGISMFFMRFMLGFSEAPSFPANARIVAAWFPTKERGTASAIFNSAQYFSLALFSPLLGWLTFAWGWEHVFTVMGVIGFVLTALWIKLIHNPTDHPRMSAEELKFISENGAVVDMDHKKPGS	GARP_ECOLI	B
C6EHM0_ECOBD	MKHKLSAILMAFMLTTPAAFAAPEATNGTEATTGTTGTTTTTTGATTTATTTGGVAAGAVGTATVVGVATAVGVATLAVVAANDSGDGGSHNTSTTTSTTR	GFCA_ECOLI	B
C6EID6_ECOBD	MVTWTQMYMPMGGLGLSALVALIPIIFFFVALAVLRLKGHVAGAITLILSILIAIFAFKMPIDMAFAAAGYGFIYGLWPIAWIIVAAVFLYKLTVASGQFDIIRSSVISITDDQRLQVLLIGFSFGALLEGAAGFGAPVAITGALLVGLGFKPLYAAGLCLIANTAPVAFGALGVPILVAGQVTGIDPFHIGAMAGRQLPFLSVLVPFWLVAMMDGWKGVKETWPAALVAGG	GLCA_ECOLI	B
C6E9W1_ECOBD	MLSIFKPAPHKARLPAAEIDPTYRRLRWQIFLGIFFGYAAYYLVRKNFALAMPYLVEQGFSRGDLGFALSGISIAYGFSKFIMGSVSDRSNPRVFLPAGLILAAAVMLFMGFVPWATSSIAVMFVLLFLCGWFQGMGWPPCGRTMVHWWSQKERGGIVSVWNCAHNVGGGIPPLLFLLGMAWFNDWHAALYMPAFCAILVALFAFAMMRDTPQSCGLPPIEEYKNDYPDDYN	GLPT_ECOLI	B
C6EHA2_ECOBD	MKIVIAPDSYKESLSASEVAQAIEKGFREIFPDAQYVSVPVADGGEGTVEAMIAATQGAERHAWVTGPLGEKVNASWGISGDGKTAFIEMAAASGLELVPAEKRDPLVTTSRGTGELILQALESGATNIIIGIGGSATNDGGAGMVQALGAKLCDANGNEIGFGGGSLNTLNDIDISGLDPRLKDCVIRVACDVTNPLVGDNGASRIFGPQKGASEAMIVELDNNLSHYAEV	GLXK2_ECOLI	B
C6EBR2_ECOBD	MHVLNILWVVFGIGLMLVLNLKFKINSMVALLVAALSVGMLAGMDLMSLLHTMKAGFGNTLGELAIIVVFGAVIGKLMVDSGAAHQIAHTLLARLGLRYVQLSVIIIGLIFGLAMFYEVAFIMLAPLVIVIAAEAKIPFLKLAIPAVAAATTAHSLFPPQPGPVALVNAYGADMGMVYIYGVLVTIPSVICAGLILPKFLGNLERPTPSFLKADQPVDMNNLPSFGVSILVP	GNTP_ECOLI	B
C6EFD9_ECOBD	MTTLTLVLTAVGSVLLLLFLVMKARMHAFLALMVVSMGAGLFSGMPLDKIAATMEKGMGGTLGFLAVVVALGAMFGKILHETGAVDQIAVKMLKSFGHSRAHYAIGLAGLVCALPLFFEVAIVLLISVAFSMARHTGTNLVKLVIPLFAGVAAAAAFLVPGPAPMLLASQMNADFGWMILIGLCAAIPGMIIAGPLWGNFISRYVELHIPDDISEPHLGEGKMPSFGFSLSL	GNTU_ECOLI	B
C6EIV0_ECOBD	MRLFNWRRQAVLNAMPLVKPDQVRTPWHEFWRRFRRQHMAMTAALFVILLIVVAIFARWIAPYDAENYFDYDNLNNGPSLQHWFGVDSLGRDIFSRVLVGAQISLAAGVFAVFIGAAIGTLLGLLAGYYEGWWDRLIMRICDVLFAFPGILLAIAVVAVLGSGIANVIIAVAIFSIPAFARLVRGNTLVLKQQTFIESARSIGASDMTVLLRHILPGTVSSIVVFFTMRIGT	GSID_ECOLI	B
C6EGE3_ECOBD	MSTRREVILSWLCEKRQTWRLCYLLGEAGSGKTWLAQQLQKDKHRRVITLSLVVSWQGKAAWIVTDDNAAEQGCRDSAWTRDEMAGQLLHALHRTDSRCPLIIIENAHLNHRRILDDLQRAISLIPDGQFLLIGRPDRKVERDFKKQGIELVSIGRLTEHELKASILEGQNIDQPDLLLTARVLKRIALLCRGDRRKLALAGETIRLLQQAEQTSVFTAKQWRMIYRILGDN	GSPA_ECOLI	B
C6EGE2_ECOBD	MPTLRFPFHLANHNKDAAINILIIFISIGSIIFNVNYFHTTIVKNGQIINQPTNAFQSDFSLAALWRNENHAGVKDANPVAVNQETPKLSIALNGIVLTSNDETSFVLINEGSEQKRYSLNEALESAPGTFIRKINKTSVVFETHGHYEKVTLHPGLPDIIKQPDSESQNVLADYIIATPIRDGEQIYGLRLNPRKGLNAFTTSLLQPGDIALRINNLSLTHPDEVSQALSL	GSPC_ECOLI	B
C6EGD8_ECOBD	MRATDKQRGFTLLEIMVVIVIIGVLASLVVPNLMGNKEKADKQKAVSDIVALENALDMYKLDNHHYPTTNQGLESLVEAPTLPPLAANYNKEGYIKRLPADPWGNDYVLVNPGEHGAYDLLSAGPDGEMGTEDDITNWGLSKKKK	GSPG_ECOLI	B
C6EGD3_ECOBD	MPESLMVIRSSSTLRKHWEWMTFSADSVSSVHTLTDDLPLESLADQPGAGNVHLLIPPEGLLYRSLTLPNAKYKLTAQTLQWLAEETLPDNTQDWHWTVVDKQNESVEVIGIQSEKLGRYLERLHTAGLNVTRVLPDGCYLPWEVDSWTLVNQQTSWLIRSAAHAFNELDEHWLQHLAAQFPPENMLCYGVVPHGVAAANPLIQHPEIPSLSLYSADIAFQRYDMLHGIFRK	GSPL_ECOLI	B
C6EGD2_ECOBD	MIKSWWAEKSTSEKQIVAALAVLSLGVFCWLGVIKPIDTYIAEHQSHAQKIKKDIKWMQDQASTHGLLGHPALTQPIKNILLEEAKRENLAITLENGPDNTLTIHPVTAPLENVSRWLTTAQVTYGIVIEDLQFTLAGNEEITLRHLSFREQQ	GSPM_ECOLI	B
C6EJ83_ECOBD	MSSLSQAASSVEKRTNARYWIVVMLFIVTSFNYGDRATLSIAGSEMAKDIGLDPVGMGYVFSAFSWAYVIGQIPGGWLLDRFGSKRVYFWSIFIWSMFTLLQGFVDIFSGFGIIVALFTLRFLVGLAEAPSFPGNSRIVAAWFPAQERGTAVSIFNSAQYFATVIFAPIMGWLTHEVGWSHVFFFMGGLGIVISFIWLKVIHEPNQHPGVNQKELEYIAAGGALINMDQQNT	GUDP_ECOLI	B
C6EKH1_ECOBD	MVLQSTRWLALGYFTYFFSYGIFLPFWSVWLKGIGLTPETIGLLLGAGLVARFLGSLLIAPRVSDPSRLIFALRVLALLTLLFAVAFWAGAHVAWLMLVMIGFNLFFSPLVPLTDALANTWQKQFPLDYGKVRLWGSVAFVIGSALTGKLVTMFDYRVILALLTLGVASMLLGFLIRPTIQPQGASRQQESTGWSAWLALVRQNWRFLACVCLLQGAHAAYYGFSAIYWQAA	HCAT_ECOLI	B
C6EEH4_ECOBD	MLYIDKATILKFDLEMLKKHRRAIQFIAVLLFIVGLLCISFPFVSGDILSTVVGALLICSGIALIVGLFSNRSHNFWPVLSGFLVAVAYLLIGYFFIRAPELGIFAIAAFIAGLFCVAGVIRLMSWYRQRSMKGSWLQLVIGVLDIVIAWIFLGATPMVSVTLVSTLVGIELIFSAASLFSFASLFVKQQ	HDED_ECOLI	B
C6EAV1_ECOBD	MASKQLWRWHGITGDGNAQDGMLWAESRTLLLMALQQQMVTPLSLKRIAINSAQWRGDKSAEVIHQLATLLKAGLTLSEGLALLAEQHPSKQWQALLQSLAHDLEQGIAFSNALLPWSEVFPPLYQAMIRTGELTGKLDECCFELARQQKAQRQLTDKVKSALRYPIIILAMAIMVVVAMLHFVLPEFAAIYKTFNTPLPALTQGIMTLADFSGEWSWLLVLFGFLLAIANK	HOFC_ECOLI	B
C6EEC3_ECOBD	MPQKYRLLSLIVICFTLLFFTWMIRDSLCELHIKQESYELAAFLACKLKE	HOKA_ECOLI	B
C6EKB6_ECOBD	MLTKYALAAVIVLCLTVLGFTLLVGDSLCEFTVKERNIEFKAVLAYEPKK	HOKE_ECOLI	B
C6EJK7_ECOBD	MNLTTLTHRDALCLNARFTSREEAIHALTQRLAALGKISSTEQFLEEVYRRESLGPTALGEGLAVPHGKTAAVKEAAFAVATLSEPLQWEGVDGPEAVDLVVLLAIPPNEAGTTHMQLLTALTTRLADDEIRARIQSATTPDELLSALDDKGGTQPSASFSNAPTIVCVTACPAGIAHTYMAAEYLEKAGRKLGVNVYVEKQGANGIEGRLTADQLNSATACIFAAEVAIKE	HRSA_ECOLI	B
C6EG48_ECOBD	MSDKKKRSMAGLPWIAAMAFFMQALDATILNTALPAIAHSLNRSPLAMQSAIISYTLTVAMLIPVSGWLADRFGTRRIFTLAVSLFTLGSLACALSNSLPQLVVFRVIQGIGGAMMMPVARLALLRAYPRNELLPVLNFVAMPGLVGPILGPVLGGVLVTWATWHWIFLINIPIGIAGLLYARKHMPNFTTARRRFDITGFLLFGLSLVLFSSGIELFGEKIVASWIALTVI	HSRA_ECOLI	B
C6EHZ7_ECOBD	MSHDPQPLGGKIISKPVMIFGPLIVICMLLIVKRLVFGLGSVSDLNGGFPWGVWIAFDLLIGTGFACGGWALAWAVYVFNRGQYHPLVRPALLASLFGYSLGGLSITIDVGRYWNLPYFYIPGHFNVNSVLFETAVCMTIYIGVMALEFAPALFERLGWKVSLQRLNKVMFFIIALGALLPTMHQSSMGSLMISAGYKVHPLWQSYEMLPLFSLLTAFIMGFSIVIFEGSLV	HYBB_ECOLI	B
C6EJE5_ECOBD	MSAISLINSGVAWFVAAAVLAFLFSFQKALSGWIAGIGGAVGSLYTAAAGFTVLTGAVGVSGALSLVSYDVQISPLNAIWLITLGLCGLFVSLYNIDWHRHAQVKCNGLQINMLMAAAVCAVIASNLGMFVVMAEIMALCAVFLTSNSKEGKLWFALGRLGTLLLAIACWLLWQRYGTLDLRLLDMRMQQLPLGSDIWLLGVIGFGLLAGIIPLHGWVPQAHANASAPAAAL	HYCC_ECOLI	B
C6EJE6_ECOBD	MSVLYPLIQALVLFAVAPLLSGITRVARARLHNRRGPGVLQEYRDMFKLLGRQSVGPDASGWVFRLTPYVMVGVMLTIATALPVVTVGSPLPQLGDLITLLYLFAIARFFFAISGLDTGSPFTAIGASREAMLGVLVEPMLLLGLWVAAQVAGSTNISNITDTVYHWPLSQSIPLVLALCACAFATFIEMGKLPFDLAEAEQELQEGPLSEYSGSGFGVMKWGISLKQLVVL	HYCD_ECOLI	B
C6EJE7_ECOBD	MSEEKLGQHYLAALNEAFPGVVLDHAWQTKDQLTVTVKVNYLPEVVEFLYYKQGGWLSVLFGNDERKLNGHYAVYYVLSMEKGTKCWITVRVEVDANKPEYPSVTPRVPAAVWGEREVRDMYGLIPVGLPDERRLVLPDDWPDELYPLRKDSMDYRQRPAPTTDAETYEFINELGDKKNNVVPIGPLHVTSDEPGHFRLFVDGENIIDADYRLFYVHRGMEKLAETRMGYNE	HYCE_ECOLI	B
C6EKM9_ECOBD	MDALQLLTWSLILYLFASLASLFLLGLDRLAIKLSGITSLVGGVIGIISGITQLHAGVTLVARFATPFEFADLTLRMDSLSAFMVLVISLLVVVCSLYSLTYMREYEGKGAAAMGFFMNIFIASMVALLVMDNAFWFIVLFEMMSLSSWFLVIARQDKTSINAGMLYFFIAHAGSVLIMIAFLLMGRESGSLDFASFRTLSLSPGLASAVFLLAFFGFGAKAGMMPLHSWLP	HYFB_ECOLI	B
C6EKM7_ECOBD	MGVLFAALTTLCMLSLISAFYQADKVAVTLTLVNVGDVALFGLVIDRVSTLILFVVVFLGLLVTIYSTGYLTDKNREHPHNGTNRYYAFLLVFIGAMAGLVLSSTLLGQLLFFEITGGCSWALISYYQSDKAQRSALKALLITHIGSLGLYLAAATLFLQTGTFALSAMSELHGDARYLVYGGILFAAWGKSAQLPMQAWLPDAMEAPTPISAYLHAASMVKVGVYIFARAI	HYFD_ECOLI	B
C6EKM6_ECOBD	MTGSMIVNNLAGLMMLTSLFVISVKSYRLSCGFYACQSLVLVSIFATLSCLFAAEQLLIWSASAFITKVLLVPLIMTYAARNIPQNIPEKALFGPAMMALLAALIVLLCAFVVQPVKLPMATGLKPALAVALGHFLLGLLCIVSQRNILRQIFGYCLMENGSHLVLALLAWRAPELVEIGIATDAIFAVIVMVLLARKIWRTHGTLDVNNLTALKG	HYFE_ECOLI	B
C6EKM5_ECOBD	MSYSVMFALLLLTPLLFSLLCFACRKRRLSATRTVTVLHSLGITLLLILALWVVQTAADAGEIFAAGLWLHIDGLGGLFLAILGVIGFLTGIYSIGYMRHEVAHGELSPVTLCDYYGFFHLFLFTMLLVVTSNNLIVMWAAIEATTLSSAFLVGIYGQRSSLEAAWKYIIICTVGVAFGLFGTVLVYANAASVMPQAEMAIFWSEVLKQSSLLDPTLMLLAFVFLLIGFGTK	HYFF_ECOLI	B
C6EKM4_ECOBD	MNVNSSSNRGEAILAALKTQFPGAVLDEERQTPEQVTITVKINLLPDVVQYLYYQHDGWLPVLFGNDERTLNGHYAVYYALSMEGAEKCWIVVKALVDADSREFPSVTPRVPAAVWGEREIRDMYGLIPVGLPDQRRLVLPDDWPEDMHPLRKDAMDYRLRPEPTTDSETYPFINEGNSDARVIPVGPLHITSDEPGHFRLFVDGEQIVDADYRLFYVHRGMEKLAETRMGY	HYFG_ECOLI	B
C6EC84_ECOBD	MQVKTQSCVVAGKKTVAVTEQTIDWNNNGTLVQITRGGICGSDLHYYQEGKVGNFMIKAPMVLGHEVIGKVIHSDSSELHEGQTVAINPSKPCGHCKYCIEHNENQCTDMRFFGSAMYFPHVDGGFTRYKMVETSQCVPYPAKADEKVMAFAEPLAVAIHAAHQAGELQGKRVFISGVGPIGCLIVSAVKTLGAAEIVCADVSPRSLSLGKEMGADVLVNPQNDDMDHWKAE	IDND_ECOLI	B
C6EC86_ECOBD	MPLIIIAAGVALLLILMIVFKVNGFIALVLVAAVVGFAEGMDAQAVLHSIQNGIGSTLGGLAMILGFGAMLGKLISDTGAAQRIATTLIATFGKKRVQWALVITGLVVGLAMFFEVGFVLLLPLVFTIVASSGLPLLYVGVPMVAALSVTHCFLPPHPGPTAIATIFEANLGTTLLYGFIITIPTVIVAGPLFSKLLTRFEKAPPEGLFNPHLFSEEEMPSFWNSIFAAVIP	IDNT_ECOLI	B
C6EFY2_ECOBD	MKQFLDFLPLVVFFAFYKIYDIYAATAALIVATAIVLIYSWVRFRKVEKMALITFVLVVVFGGLTLFFHNDEFIKWKVTVIYALFAGALLVSQWVMKKPLIQRMLGKELTLPQPVWSKLNLAWAVFFILCGLANIYIAFWLPQNIWVNFKVFGLTALTLIFTLLSGIYIYRHMPQEDKS	ISPZ_ECOLI	B
C6EEY8_ECOBD	MQIKRSIEKIPGGMMLVPLFLGALCHTFSPGAGKYFGSFTNGMITGTVPILAVWFFCMGASIKLSATGTVLRKSGTLVVTKIAVAWVVAAIASRIIPEHGVEVGFFAGLSTLALVAAMDMTNGGLYASIMQQYGTKEEAGAFVLMSLESGPLMTMIILGTAGIASFEPHVFVGAVLPFLVGFALGNLDPELREFFSKAVQTLIPFFAFALGNTIDLTVIAQTGLLGILLGVA	KDGT_ECOLI	B
C6ELN7_ECOBD	MYYLKNTNFWMFGLFFFFYFFIMGAYFPFFPIWLHDINHISKSDTGIIFAAISLFSLLFQPLFGLLSDKLGLRKYLLWIITGMLVMFAPFFIFIFGPLLQYNILVGSIVGGIYLGFCFNAGAPAVEAFIEKVSRRSNFEFGRARMFGCVGWALCASIVGIMFTINNQFVFWLGSGCALILAVLLFFAKTDAPSSATVANAVGANHSAFSLKLALELFRQPKLWFLSLYVIGV	LACY_ECOLI	B
C6EGP9_ECOBD	MTLAQFAMTFWHDLAAPILAGIITAAIVGWWRNRK	LDRB_ECOLI	B
C6EGQ0_ECOBD	MLSLQQGGYMTLAQFAMIFWDDLAAPILAGIITAAIVGWWRNRK	LDRB_ECOLI	B
C6EEE4_ECOBD	MTFAELGMAFWHDLAAPVIAGILASMIVNWLNKRK	LDRD_ECOLI	B
C6EGD1_ECOBD	MTMLLPLFILVGFIAGYFVNAIAYHLSPLEDKTALTFRQVLVHFRQKKYAWHDTVPLILCVAAAIACALAPFTPIVTSALFLYFCFVLTLSVIDFRTQLLPDKLTLPLLWLGLVFNAQYGLIDLHDAVYGAVAGYGVLWCVYWGVWLVCHKEGLGYGDFKLLAAAGAWCGWQTLPMILLIASLGGIGYAIVSQLLQRRTITTIAFGPWLALGSMINLGYLAWISY	LEP4_ECOLI	B
C6EC32_ECOBD	MFAEYGVLNYWTYLVGAIFIVLVPGPNTLFVLKNSVSSGMKGGYLAACGVFIGDAVLMFLAWAGVATLIKTTPILFNIIRYLGAFYLLYLGSKILYATLKGKNNEAKSDEPQYGAIFKRALILSLTNPKAILFYVSFFVQFIDVNAPHTGISFFILATTLELVSFCYLSFLIISGAFVTQYIRTKKKLAKVGNSLIGLMFVGFAARLATLQS	LEUE_ECOLI	B
C6ECV0_ECOBD	MADNPDPSSLLPDVFSPATRDWFLRAFKQPTAVQPQTWHVAARSEHALVIAPTGSGKTLAAFLYALDRLFREGGEDTREAHKRKTSRILYISPIKALGTDVQRNLQIPLKGIADERRRRGETEVNLRVGIRTGDTPAQERSKLTRNPPDILITTPESLYLMLTSRARETLRGVETVIIDEVHAVAGSKRGAHLALSLERLDALLHTSAQRIGLSATVRSASDVAAFLGGDRP	LHR_ECOLI	B
C6EFB7_ECOBD	MSEQFLYFLQQMFNGVTLGSTYALIAIGYTMVYGIIGMINFAHGEVYMIGSYVSFMIIAALMMMGIDTGWLLVAAGFVGAIVIASAYGWSIERVAYRPVRNSKRLIALISAIGMSIFLQNYVSLTEGSRDVALPSLFNGQWVVGHSENFSASITTMQAVIWIVTFLAMLALTIFIRYSRMGRACRACAEDLKMASLLGINTDRVIALTFVIGAAMAAVAGVLLGQFYGVINP	LIVH_ECOLI	B
C6EFB8_ECOBD	MKPMHIAMALLSAAMFFVLAGVFMGVQLELDGTKLVVDTASDVRWQWVFIGTAVVFFFQLLRPAFQKGLKSVSGPKFILPAIDGSTVKQKLFLVALLVLAVAWPFMVSRGTVDIATLTMIYIILGLGLNVVVGLSGLLVLGYGGFYAIGAYTFALLNHYYGLGFWTCLPIAGLMAAAAGFLLGFPVLRLRGDYLAIVTLGFGEIVRILLLNNTEITGGPNGISQIPKPTLFG	LIVM_ECOLI	B
C6EDI6_ECOBD	MNLWQQNYDPAGNIWLSSLIASLPILFFFFALIKLKLKGYVAASWTVAIALAVALLFYKMPVANALASVVYGFFYGLWPIAWIIIAAVFVYKISVKTGQFDIIRSSILSITPDQRLQMLIVGFCFGAFLEGAAGFGAPVAITAALLVGLGFKPLYAAGLCLIVNTAPVAFGAMGIPILVAGQVTGIDSFEIGQMVGRQLPFMTIIVLFWIMAIMDGWRGIKETWPAVVVAGG	LLDP_ECOLI	B
C6EJ33_ECOBD	MSESVHTNTSLWSKGMKAVIVAQFLSAFGDNALLFATLALLKAQFYPEWSQPILQMVFVGAYILFAPFVGQVADSFAKGRVMMFANGLKLLGAASICFGINPFLGYTLVGVGAAAYSPAKYGILGELTTGSKLVKANGLMEASTIAAILLGSVAGGVLADWHVLVALAACALAYGGAVVANIYIPKLAAARPGQSWNLINMTRSFLNACTSLWRNGETRFSLVGTSLFWGAG	LPLT_ECOLI	B
C6EDZ0_ECOBD	MDVIKKKHWWQSDALKWSVLGLLGLLVGYLVVLMYAQGEYLFAITTLILSSAGLYIFANRKAYAWRYVYPGMAGMGLFVLFPLVCTIAIAFTNYSSTNQLTFERAQEVLLDRSWQAGKTYNFGLYPAGDEWQLALSDGETGKNYLSDAFKFGGEQKLQLKETTAQPEGERANLRVITQNRQALSDITAILPDGNKVMMSSLRQFSGTQPLYTLDGDGTLTNNQSGVKYRPNN	MALF_ECOLI	B
C6EDZ1_ECOBD	MAMVQPKSQKARLFITHLLLLLFIAAIMFPLLMVVAISLRQGNFATGSLIPEQISWDHWKLALGFSVEQADGRITPPPFPVLLWLWNSVKVAGISAIGIVALSTTCAYAFARMRFPGKATLLKGMLIFQMFPAVLSLVALYALFDRLGEYIPFIGLNTHGGVIFAYLGGIALHVWTIKGYFETIDSSLEEAAALDGATPWQAFRLVLLPLSVPILAVVFILSFIAAITEVPV	MALG_ECOLI	B
C6EDM5_ECOBD	MFDFSKVVDRHGTWCTQWDYVADRFGTADLLPFTISDMDFATAPCIIEALNQRLMHGVFGYSRWKNDEFLAAIAHWFSTQHYTAIDPQSVVYGPSVIYMVSELIRQWSETGEGVVIHTPAYDAFYKAIEGNQRTVMPVALEKQADGWFCDMGKLEAVLAKPECKIMLLCSPQNPTGKVWTCDELEIMADLCERHGVRVISDEIHMDMVWGEQPHIPWSNVARGDWALLTSGS	MALY_ECOLI	B
C6EI10_ECOBD	MNNEETFYQAMRRQGVTRRSFLKYCSLAATSLGLGAGMAPKIAWALENKPRIPVVWIHGLECTCCTESFIRSAHPLAKDVILSLISLDYDDTLMAAAGTQAEEVFEDIITQYNGKYILAVEGNPPLGEQGMFCISSGRPFIEKLKRAAAGASAIIAWGTCASWGCVQAARPNPTQATPIDKVITDKPIIKVPGCPPIPDVMSAIITYMVTFDRLPDVDRMGRPLMFYGQRIH	MBHS_ECOLI	B
C6EBL4_ECOBD	MLKRIKIVTSLLLVLAVFGLLQLTSGGLFFNALKNDKENFTVLQTIRQQQSTLNGSWVALLQTRNTLNRAGIRYMMDQNNIGSGSTVAELMQSASISLKQAEKNWADYEALPRDPRQSTAAAAEIKRNYDIYHNALAELIQLLGAGKINEFFDQPTQGYQDGFEKQYVAYMEQNDRLYDIAVSDNNASYSQAMWILVGVMIVVLAVIFAVWFGIKASLVAPMNRLIDSIRHI	MCP1_ECOLI	B
C6EBU1_ECOBD	MINRIRVVTLLVMVLGVFALLQLISGSLFFSSLHHSQKSFVVSNQLREQQGELTSTWDLMLQTRINLSRSAVRMMMDSSNQQSNAKVELLDSARKTLAQAATHYKKFKSMAPLPEMVATSRNIDEKYKNYYTALTELIDYLDYGNTGAYFAQPTQGMQNAMGEAFAQYALSSEKLYRDIVTDNADDYRFAQWQLAVIALVVVLILLVAWYGIRRMLLTPLAKIIAHIREIAG	MCP2_ECOLI	B
C6EBU2_ECOBD	MFNRIRISTTLFLILILCGILQIGSNGMSFWAFRDDLQRLNQVEQSNKQRAALAQTRAVMLQASTALNKAGTLTALSYPADDIKTLMTTARASLTQSTTLFKSFMAMTAGNEHVRGLQKETEKSFARWHNDLEHQATWLESNQLSDFLTAPVQGSQNAFDVNFEAWQLEINHVLEAASAQSQRNYQISALVFISMIIVAAIYISSALWWTRKMIVQPLAIIGSHFDSIAAGN	MCP4_ECOLI	B
C6EAM8_ECOBD	MTDLPDSTRWQLWIVAFGFFMQSLDTTIVNTALPSMAQSLGESPLHMHMVIVSYVLTVAVMLPASGWLADKVGVRNIFFTAIVLFTLGSLFCALSGTLNELLLARALQGVGGAMMVPVGRLTVMKIVPREQYMAAMTFVTLPGQVGPLLGPALGGLLVEYASWHWIFLINIPVGIIGAIATLLLMPNYTMQTRRFDLSGFLLLAVGMAVLTLALDGSKGTGLSPLTIAGLVA	MDTD_ECOLI	B
C6EHE8_ECOBD	MSRVSQARNLGKYFLLIDNMLVVLGFFVVFPLISIRFVDQMGWAAVMVGIALGLRQFIQQGLGIFGGAIADRFGAKPMIVTGMLMRAAGFATMGIAHEPWLLWFSCLLSGLGGTLFDPPRSALVVKLIRPQQRGRFFSLLMMQDSAGAVIGALLGSWLLQYDFRLVCATGAVLFVLCAAFNAWLLPAWKLSTVRTPVREGMTRVMRDKRFVTYVLTLAGYYMLAVQVMLMLP	MDTH_ECOLI	B
C6EDP9_ECOBD	MAQFEWVHAAWLALAIVLEIVANVFLKFSDGFRRKIFGLLSLAAVLAAFSALSQAVKGIDLSVAYALWGGFGIAATLAAGWILFGQRLNRKGWIGLVLLLAGMIMVKLA	MDTI_ECOLI	B
C6EDP8_ECOBD	MYIYWILLGLAIATEITGTLSMKWASVSEGNGGFILMLVMISLSYIFLSFAVKKIALGVAYALWEGIGILFITLFSVLLFDESLSLMKIAGLTTLVAGIVLIKSGTRKARKPELEVNHGAV	MDTJ_ECOLI	B
C6EG93_ECOBD	MSRFLICSFALVLLYPAGIDMYLVGLPRIAADLNASEAQLHIAFSVYLAGMAAAMLFAGKVADRSGRKPVAIPGAALFIIASVFCSLAETSTLFLAGRFLQGLGAGCCYVVAFAILRDTLDDRRRAKVLSLLNGITCIIPVLAPVLGHLIMLKFPWQSLFWAMAMMGIAVLMLSLFILKETRPASPAASDKPRENSESLLNRFFLSRVVITTLSVSVILTFVNTSPVLLMEI	MDTL_ECOLI	B
C6EBP1_ECOBD	MPRFFTRHAATLFFPMALILYDFAAYLSTDLIQPGIINVVRDFNADVSLAPAAVSLYLAGGMALQWLLGPLSDRIGRRPVLITGALIFTLACAATMFTTSMTQFLIARAIQGTSICFIATVGYVTVQEAFGQTKGIKLMAIITSIVLIAPIIGPLSGAALMHFMHWKVLFAIIAVMGFISFVGLLLAMPETVKRGAVPFSAKSVLRDFRNVFCNRLFLFGAATISLSYIPMM	MDTM_ECOLI	B
C6ED42_ECOBD	MESTPKKAPRSKFPALLVVALALVALVFVIWRVDSAPSTNDAYASADTIDVVPEVSGRIVELAVTDNQAVKQGDLLFRIDPRPYEANLAKAEASLAALDKQIMLTQRSVDAQQFGADSVNATVEKARAAAKQATDTLRRTEPLLKEGFVSAEDVDRARTAQRAAEADLNAVLLQAQSAASAVSGVDALVAQRAAVEADIALTKLHLEMATVRAPFDGRVISLKTSVGQFASA	MDTN_ECOLI	B
C6ED43_ECOBD	MSALNSLPLPVVRLLAFFHEELSERRPGRVPQTVQLWVGCLLVILISMTFEIPFVALSLAVLFYGIQSNAFYTKFVAILFVVATVLEIGSLFLIYKWSYGEPLIRLIIAGPILMGCMFLMRTHRLGLVFFAVAIVAIYGQTFPAMLDYPEVVVRLTLWCIVVGLYPTLLMTLIGVLWFPSRAISQMHQALNDRLDDAISHLTDSLAPLPETRIEREALALQKLNVFCLADDA	MDTO_ECOLI	B
C6ED04_ECOBD	MTTKLSYGFGAFGKDFAIGIVYMYLMYYYTDVVGLSVGLVGTLFLVARIWDAINDPIMGWIVNATRSRWGKFKPWILIGTLANSVILFLLFSAHLFEGTTQIVFVCVTYILWGMTYTIMDIPFWSLVPTITLDKREREQLVPYPRFFASLAGFVTAGVTLPFVNYVGGGDRGFGFQMFTLVLIAFFIVSTIITLRNVHEVFSSDNQPSAEGSHLTLKAIVALIYKNDQLSCL	MELB_ECOLI	B
C6ELN3_ECOBD	MAIQHPDIQPAVNHSVQVAIAGAGPVGLMMANYLGQMGIDVLVVEKLDKLIDYPRAIGIDDEALRTMQSVGLVDDVLPHTTPWHAMRFLTPKGRCFADIQPMTDEFGWPRRNAFIQPQVDAVMLEGVSRFPNVRCLFSRELEAFSQQDDEVTLHLKTAEGQREIVKAQWLVACDGGASFVRRTLNVPFEGKTAPNQWIVVDIANDPLSTPHIYLCCDPVRPYVSAALPHAVR	MHPA_ECOLI	B
C6ELM7_ECOBD	MSTRTPSSSSSRLMLTIGLCFLVALMEGLDLQAAGIAAGGIAQAFALDKMQMGWIFSAGILGLLPGALVGGMLADRYGRKRILIGSVALFGLFSLATAIAWDFPSLVFARLMTGVGLGAALPNLIALTSEAAGPRFRGTAVSLMYCGVPIGAALAATLGFAGANLAWQTVFWVGGVVPLILVPLLMRWLPESAVFAGEKQSAPPLRALFAPETATATLLLWLCYFFTLLVVY	MHPT_ECOLI	B
C6EL77_ECOBD	MTNYRVESSSGRAARKTRLALMGPAFIAAIGYIDPGNFATNIQAGASFGYQLLWVVVWANLMAMLIQILSAKLGIATGKNLAEQIRDHYPRPVVWFYWVQAEIIAMATDLAEFIGAAIGFKLILGVSLLQGAVLTGIATFLILMLQRRGQKPLEKVIGGLLLFVAAAYIVELIFSQPNLAQLGKGMVIPSLPTSEAVFLAAGVLGATIMPHVIYLHSSLTQHLHGGSRQQRY	MNTH_ECOLI	B
C6EF47_ECOBD	MAGKTMIPLLAFAAWSGTGKTTLLKKLIPALCARGIRPGLIKHTHHDMDVDKPGKDSYELRKAGAAQTIVASQQRWALMTETPDEEELDLQFLASRMDTSKLDLILVEGFKHEEIAKIVLFRDGAGHRPEELVIDRHVIAVASDVPLNLDVALLDINDVEGLADFVVEWMQKQNG	MOBB_ECOLI	B
C6EB36_ECOBD	MKQHKAMIVALIVICITAVVAALVTRKDLCEVHIRTGQTEVAVFTAYESE	MOKC_ECOLI	B
C6EBT7_ECOBD	MLILLGYLVVLGTVFGGYLMTGGSLGALYQPAELVIIAGAGIGSFIVGNNGKAIKGTLKALPLLFRRSKYTKAMYMDLLALLYRLMAKSRQMGMFSLERDIENPRESEIFASYPRILADSVMLDFIVDYLRLIISGHMNTFEIEALMDEEIETHESEAEVPANSLALVGDSLPAFGIVAAVMGVVHALGSADRPAAELGALIAHAMVGTFLGILLAYGFISPLATVLRQKSA	MOTA_ECOLI	B
C6EBT8_ECOBD	MKNQAHPIIVVKRRKAKSHGAAHGSWKIAYADFMTAMMAFFLVMWLISISSPKELIQIAEYFRTPLATAVTGGDRISNSESPIPGGGDDYTQSQGEVNKQPNIEELKKRMEQSRLRKLRGDLDQLIESDPKLRALRPHLKIDLVQEGLRIQIIDSQNRPMFRTGSADVEPYMRDILRAIAPVLNGIPNRISLSGHTDDFPYASGEKGYSNWELSADRANASRRELMVGGLDS	MOTB_ECOLI	B
C6EGL2_ECOBD	MASYRSQGRWVIWLSFLIALLLQIMPWPDNLIVFRPNWVLLILLYWILALPHRVNVGTGFVMGAILDLISGSTLGVRVLAMSIIAYLVALKYQLFRNLALWQQALVVMLLSLVVDIIVFWAEFLVINVSFRPEVFWSSVVNGVLWPWIFLLMRKVRQQFAVQ	MRED_ECOLI	B
C6EHF4_ECOBD	MKYDLIIIGSGSVGAAAGYYATRAGLNVLMTDAHMPPHQHGSHHGDTRLIRHAYGEGEKYVPLVLRAQTLWDELSRHNEEDPIFVRSGVINLGPADSTFLANVAHSAEQWQLNVEKLDAQGIMARWPEIRVPDNYIGLFETDSGFLRSELAIKTWIQLAKEAGCAQLFNCPVTAIRHDDDGVTIETADGEYQAKKAIVCAGTWVKDLLPELPVQPVRKVFAWYQADGRYSVK	MTOX_ECOLI	B
C6EH64_ECOBD	MATLTTTQTSPSLLGGVVIIGGTIIGAGMFSLPVVMSGAWFFWSMAALIFTWFCMLHSGLMILEANLNYRIGSSFDTITKDLLGKGWNVVNGISIAFVLYILTYAYISASGSILHHTFAEMSLNVPARAAGFGFALLVAFVVWLSTKAVSRMTAIVLGAKVITFFLTFGSLLGHVQPATLFNVAESNASYAPYLLMTLPFCLASFGYHGNVPSLMKYYGKDPKTIVKCLVYG	MTR_ECOLI	B
C6EH10_ECOBD	MTTLAIDIGGTKLAAALIGADGQIRDRRELPTPASQTPEALRDALSALVSPLQAHAQRVAIASTGIIRDGSLLALNPHNLGGLLHFPLVKTLEQLTNLPTIAINDAQAAAWAEYQALEGDITDMVFITVSTGVGGGVVSGGKLLTGPGGLAGHIGHTLADPHGPVCGCGRTGCVEAIASGRGIAAAAQGELAGADARTIFTRAGQGDEQAQQLIHRSARTLARLIADIKATT	NANK_ECOLI	B
C6EH08_ECOBD	MSTTTQNIPWYRHLNRAQWRAFSAAWLGYLLDGFDFVLIALVLTEVQGEFGLTTVQAASLISAAFISRWFGGLMLGAMGDRYGRRLAMVTSIVLFSAGTLACGFAPGYITMFIARLVIGMGMAGEYGSSATYVIESWPKHLRNKASGFLISGFSVGAVVAAQVYSLVVPVWGWRALFFIGILPIIFALWLRKNIPEAEDWKEKHAGKAPVRTMVDILYRGEHRIANIVMTLA	NANT_ECOLI	B
C6E9Z8_ECOBD	MGNSDRKPGLIKRLWKWWRTPSRLALGTLLLIGFVGGIVFWGGFNTGMEKANTEEFCISCHEMRNTVYQEYMDSVHYNNRSGVRATCPDCHVPHEFVPKMIRKLKASKELYGKIFGVIDTPQKFEAHRLTMAQNEWRRMKDNNSQECRNCHNFEYMDTTAQKSVAAKMHDQAVKDGQTCIDCHKGIAHKLPDMREVEPGF	NAPC_ECOLI	B
C6E9Z6_ECOBD	MANRKRDAGREALEKKGWWRSHRWLVLRRLCQFFVLGMFLSGPWFGVWILHGNYSSSLLFDTVPLTDPLMTLQSLASGHLPATVALTGAVIITVLYALAGKRLFCSWVCPLNPITDLANWLRRRFDLNQSATIPRHIRYVLLVVILVGSALTGTLIWEWINPVSLMGRSLVMGFGSGALLILALFLFDLLVVEHGWCGHICPVGALYGVLGSKGVITVAATDRQKCNRCMDC	NAPH_ECOLI	B
C6EGP0_ECOBD	MSHSSAPERATGAVITDWRPEDPAFWQQRGQRIASRNLWISVPCLLLAFCVWMLFSAVAVNLPKVGFNFTTDQLFMLTALPSVSGALLRVPYSFMVPIFGGRRWTAFSTGILIIPCVWLGFAVQDTSTPYSVFIIISLLCGFAGANFASSMANISFFFPKQKQGGALGLNGGLGNMGVSVMQLVAPLVVSLSIFAVFGSQGVKQPDGTELYLANASWIWVPFLAIFTIAAWF	NARK_ECOLI	B
C6EEP6_ECOBD	MALQNEKNSRYLLRDWKPENPAFWENKGKHIARRNLWISVSCLLLAFCVWMLFSAVTVNLNKIGFNFTTDQLFLLTALPSVSGALLRVPYSFMVPIFGGRRWTIFSTAILIIPCVWLGIAVQNPNTPFGIFIVIALLCGFAGANFASSMGNISFFFPKAKQGSALGINGGLGNLGVSVMQLVAPLVIFVPVFAFLGVNGVPQADGSVMSLANAAWIWVPLLAIATIAAWSGM	NARU_ECOLI	B
C6EEQ0_ECOBD	MIQYLNVFFYDIYPYICATVFFLGSWLRYDYGQYTWRASSSQMLDKRGMVIWSNLFHIGILGIFFGHLFGMLTPHWMYAWFLPVAAKQLMAMVLGGICGVLTLIGGAGLLWRRLTNQRVRATSTTPDIIIMSILLIQCLLGLSTIPFSAQYPDGSEMMKLVGWAQSIVTFRGGSSEMLNGVAFVFRLHLVLGMTIFLLFPFTRLVHVWSAPFEYFTRRYQIVRSRR	NARV_ECOLI	B
C6EF97_ECOBD	MLRYVLRRFLLLIPMVLAASVIIFLMLRLGTGDPALDYLRLSNLPPTPEMLASTRTMLGLDQPLYVQYGTWLWKALHLDFGISFASQRPVLDDMLNFLPATLELAGAALVLILLTSVPLGIWAARHRDRLPDFAVRFIAFLGVSMPNFWLAFLLVMAFSVYLQWLPAMGYGGWQHIILPAVSIAFMSLAINARLLRASMLDVAGQRHVTWARLRGLNDKQTERRHILRNASL	NIKB_ECOLI	B
C6EF96_ECOBD	MNFFLSSRWSVRLALIIIALLALIALTSQWWLPYDPQAIDLPSRLLSPDAQHWLGTDHLGRDIFSRLMAATRVSLGSVMACLLLVLTLGLVIGGSAGLIGGRVDQATMRVADMFMTFPTSILSFFMVGVLGTGLTNVIIAIALSHWAWYARMVRSLVISLRQREFVLASRLSGAGHVRVFVDHLAGAVIPSLLVLATLDIGHMMLHVAGMSFLGLGVTAPTAEWGVMINDAR	NIKC_ECOLI	B
C6EFK9_ECOBD	MFTDTINKCAANAARIARLSANNPLGFWVSSAMAGAYVGLGIILIFTLGNLLDPSVRPLVMGATFGIALTLVIIAGSELFTGHTMFLTFGVKAGSISHGQMWAILPQTWLGNLVGSVFVAMLYSWGGGSLLPVDTSIVHSVALAKTTAPAMVLFFKGALCNWLVCLAIWMALRTEGAAKFIAIWWCLLAFIASGYEHSIANMTLFALSWFGNHSEAYTLAGIGHNLLWVTLG	NIRC_ECOLI	B
C6ED52_ECOBD	MTQTSAFHFESLVWDWPIAIYLFLIGISAGLVTLAVLLRRFYPQAGGADSTLLRTTLIVGPGAVILGLLILVFHLTRPWTFWKLMFHYSFTSVMSMGVMLFQLYMVVLVLWLAKIFEHDLLALQQRWLPKLGIVQKVLSLLTPVHRGLETLMLVLAVLLGAYTGFLLSALKSYPFLNNPILPVLFLFSGISSGAAVALIAMAIRQRSNPHSTEAQFVHRMEIPVVWGEIFLL	NRFD_ECOLI	B
C6ED51_ECOBD	MLLSLGVNVLTPLTAFAGVRLRWPAMMRLTCIGILAQFALLLLAFGVLTYCFLISDFSVIYVAQHSYSLLSWELKLAAVWGGHEGSLLLWVLLLSAWSALFAWHYRQQTDPLFPLTLAVLSLMLAALLLFVVLWSDPFVRIFPPAIEGRDLNPMLQHPGLIFHPPLLYLGYGGLMVAASVALASLLRSEFDGACARICWRWALPGWSALTAGIILGSWWAYCELGWGGWWFW	NRFE_ECOLI	B
C6ED50_ECOBD	MSKGLLTLLLLFTCFARAQVVDTWQFANPQQQEQALNIASQLRCPQCQNQNLLESNAPVAVSMRHQVYSMVAEGKNEVEIIGWMTERYGDFVRYNPPLTGQTLVLWALPVVLLLLMALILWRVRAKR	NRFF_ECOLI	B
C6EAF2_ECOBD	MDVMRSVLGMVVLLTIAFLLSVNKKKISLRTVGAALVLQVVIGGIMLWLPPGRWVAEKVAFGVHKVMAYSDAGSAFIFGSLVGPKMDTLFDGAGFIFGFRVLPAIIFVTALVSILYYIGVMGILIRILGGIFQKALNISKIESFVAVTTIFLGQNEIPAIVKPFIDRLNRNELFTAICSGMASIAGSTMIGYAALGVPVEYLLAASLMAIPGGILFARLLSPATESSQVSFN	NUPX_ECOLI	B
C6EHG5_ECOBD	MNPVPAQREYFLDSIRAWLMLLGIPFHISLIYSSHTWHVNSAESSLWLTLFNDFIHSFRMQVFFVISGYFSYMLFLRYPLKKWWKVRVERVGIPMLTAIPLLTLPQFIMLQYVKGKAESWPGLSLYDKYNTLAWELISHLWFLLVLVVMTTLCVWIFKRIRNNLENSDKTNKKFSMVKLSVIFLCLGIGYAVIRRTIFIVYPPILSNGMFNFIVMQTLFYLPFFILGALAFI	OPGC_ECOLI	B
C6EGK2_ECOBD	MQLEVILPLVAYLVVVFGISVYAMRKRSTGTFLNEYFLGSRSMGGIVLAMTLTATYISASSFIGGPGAAYKYGLGWVLLAMIQLPAVWLSLGILGKKFAILARRYNAVTLNDMLFARYQSRLLVWLASLSLLVAFVGAMTVQFIGGARLLETAAGIPYETGLLIFGISIALYTAFGGFRASVLNDTMQGLVMLIGTVVLLIGVVHAAGGLSNAVQTLQTIDPQLVTPQGADD	PANF_ECOLI	B
C6EKJ0_ECOBD	MPRLLTKRGCWITLAAAPFLLFLAAWGADKLWPLPLHEVNPARVVVAQDGTPLWRFADADGIWRYPVTIEDVSPRYLEALINYEDRWFWKHPGVNPFSVARAAWQDLTSGRVISGGSTLTMQVARLLDPHPKTFGGKIRQLWRALQLEWHLSKREILTLYLNRAPFGGTLQGIGAASWAYLGKSPANLSYSEAAMLAVLPQAPSRLRPDRWPERAEAARNKVLERMAVQGVW	PBPC_ECOLI	B
C6EHI5_ECOBD	MINRIVSFFILCLVLCIPLCVAYFHSGELMMRFVFFWPFFMSIMWIVGGVYFWVYRERHWPWGENAPAPQLKDNPSISIIIPCFNEEKNVEETIHAALAQRYENIEVIAVNDGSTDKTRAILDRMAAQIPHLRVIHLAQNQGKAIALKTGAAAAKSEYLVCIDGDALLDRDAAAYIVEPMLYNPRVGAVTGNPRIRTRSTLVGKIQVGEYSSIIGLIKRTQRIYGNVFTVSG	PGAC_ECOLI	B
C6EHI6_ECOBD	MNNLIITTRQSPVRLLVDYVATTILWTLFALFIFLFAMDLLTGYYWQSEARSRLQFYFLLAVANAVVLIVWALYNKLRFQKQQHHAAYQYTPQEYAESLAIPDELYQQLQKSHRMSVHFTSQGQIKMVVSEKALVRA	PGAD_ECOLI	B
C6ELG6_ECOBD	MTILPRHKDVAKSRLKMSNPWHLLAVGFGSGLSPIVPGTMGSLAAIPFWYLMTFLPWQLYSLVVMLGICIGVYLCHQTAKDMGVHDHGSIVWDEFIGMWITLMALPTNDWQWVAAGFVIFRILDMWKPWPIRWFDRNVHGGMGIMIDDIVAGVISAGILYFIGHHWPLGILS	PGPA_ECOLI	B
C6ED20_ECOBD	MQTITIAPPKRSWFSLLSWAVVLAVLVVSWQGAEMAPLTLIKDGGNMATFAADFFPPDFSQWQDYLTEMAVTLQIAVWGTALAVVLSIPFGLMSAENLVPWWVYQPVRRLMDACRAINEMVFAMLFVVAVGLGPFAGVLALFIHTTGVLSKLLSEAVEAIEPGPVEGIRATGANKLEEILYGVLPQVMPLLISYSLYRFESNVRSATVVGMVGAGGIGVTLWEAIRGFQFQQ	PHNE_ECOLI	B
C6ECT5_ECOBD	MNPSQHAEQFQSQLANYVPQFTPEFWPVWLIIAGVLLVGMWLVLGLHALLRARGVKKSATDHGEKIYLYSKAVRLWHWSNALLFVLLLASGLINHFAMVGATAVKSLVAVHEVCGFLLLACWLGFVLINAVGDNGHHYRIRRQGWLERAAKQTRFYLFGIMQGEEHPFPATTQSKFNPLQQVAYVGVMYGLLPLLLLTGLLCLYPQAVGDVFPGVRYWLLQTHFALAFISLF	PHSC_ECOLI	B
C6EGE4_ECOBD	MFEFYIAAREQKETGHPGIFSRQKHSTIIYVICLLLICLWFAGMVLVGGYARQLWVLWIVKAEVTVEAETPAFKQSTQHYFFKKQPLPVVESVEEEDDPGVAVENAPSSSEDEENTVEESDEKAGLRERVKNALNELER	PIOO_ECOLI	B
C6EI05_ECOBD	MLNLFVGLDIYTGLLLLLALAFVLFYEAINGFHDTANAVATVIYTRAMQPQLAVVMAAFFNFFGVLLGGLSVAYAIVHMLPTDLLLNMGSTHGLAMVFSMLLAAIIWNLGTWFFGLPASSSHTLIGAIIGIGLTNALLTGSSVMDALNLREVTKIFSSLIVSPIVGLVIAGGLIFLLRRYWSGTKKRDRIHRIPEDRKKKKGKRKPPFWTRIALIVSAAGVAFSHGANDGQK	PITB_ECOLI	B
C6EJP3_ECOBD	MSQAKSNKMGVVQLTILTMVNMMGSGIIMLPTKLAEVGTISIISWLVTAVGSMALAWAFAKCGMFSRKSGGMGGYAEYAFGKSGNFMANYTYGVSLLIANVAIAISAVGYGTELLGASLSPVQIGLATIGVLWICTVANFGGARITGQISSITVWGVIIPVVGLCIIGWFWFSPTLYVDSWNPHHAPFFSAVGSSIAMTLWAFLGLESACANTDVVENPERNVPIAVLGGTL	POTE_ECOLI	B
C6EIC5_ECOBD	MSTLEPAAQSKPPGGFKLWLSQLQMKHGRKLVIALPYIWLILLFLLPFLIVFKISLGEMARAIPPYTELMEWADGQLSITLNLGNFLQLTDDPLYFDAYLQSLQVAAISTICCLLIGYPLAWAVAHSKPSTRNILLLLVILPSWTSFLIRVYAWMGILKNNGVLNNFLLWLGVIDQPLTILHTNLAVYIGIVYAYVPFMVLPIYTALIRIDYSLVEAALDLGARPLKTFFTV	POTH_ECOLI	B
C6EIC4_ECOBD	MNNLPVVRSPWRIVILLLGFTFLYAPMLMLVIYSFNSSKLVTVWAGWSTRWYGELLRDDAMMSAVGLSLTIAACAATAAAILGTIAAVVLVRFGRFRGSNGFAFMITAPLVMPDVITGLSLLLLFVALAHAIGWPADRGMLTIWLAHVTFCTAYVTVVISSRLRELDSSIEEAAMDLGATPLKVFFVITLPMIMPAIISGWLLAFTLSLDDLVIASFVSGPGATTLPMLVFS	POTI_ECOLI	B
C6EJ44_ECOBD	MPVKEQGFSLLEVLIAMAISSVLLLGAARFLPALQRESLTGTRKLALEDEIWLRVFTVAKHLQRAGYCHGSCTGEGLEIVGQGDCIIVQWDANSNGIWDREPVKESDQIGFRLKEHVLETLRGATSCEGKGWDKVTNPDAIIIDTFQVVRQDVSGFSPVLTVNMRAASKSEPQTVVDASYSVTGFNL	PPDB_ECOLI	B
C6EJ46_ECOBD	MSASLKNQQGFSLPEVMLAMVLMVMIVTALSGFQRTLMNSLASRNQYQQLWRHGWQQTQLRAISPPANWQVNRMQTSQAGCVSISVTLVSPGGREGEMTRLHCPNRQ	PPDC_ECOLI	B
C6EAU9_ECOBD	MDKQRGFTLIELMVVIGIIAILSAIGIPAYQNYLRKAALTDMLQTFVPYRTAVELCALEHGGLDTCDGGSNGIPSPTTTRYVSAMSVAKGVVSLTGQESLNGLSVVMTPGWDNANGVTGWTRNCNIQSDSALQQACEDVFRFDDAN	PPDD_ECOLI	B
C6EID8_ECOBD	MLFDVFQQYPTAMPVLATVGGLIIGSFLNVVIWRYPIMLRQQMAEFHGEMSSAQSKISLALPRSHCPHCQQTIRIRDNIPLFSWLMLKGRCRDCQAKISKRYPLVELLTALAFLLASLVWPESGWGLAVMILSAWLIAASVIDLDHQWLPDVFTQGVLWTGLIAAWAQQSPLTLQDAVTGVLVGFITFYSLRWIAGIVLRKEALGMGDVLLFAALGGWVGALSLPNVALIAS	PPPA_ECOLI	B
C6EI32_ECOBD	MCEHHHAAKHILCSQCDMLVALPRLEHGQKAACPRCGTTLTVAWDAPRQRPTAYALAALFMLLLSNLFPFVNMNVAGVTSEITLLEIPGVLFSEDYASLGTFFLLFVQLVPAFCLITILLLVNRAELPVRLKEQLARVLFQLKTWGMAEIFLAGVLVSFVKLMAYGSIGVGSSFLPWCLFCVLQLRAFQCVDRRWLWDDIAPMPELRQPLKPGVTGIRQGLRSCSCCTAILP	PQIA_ECOLI	B
C6EDZ3_ECOBD	MTSLSRPRVEFISTILQTVLNLGLLCLGLILVVFLGKETVHLADVLFAPEQTSKYELVEGLVVYFLYFEFIALIVKYFQSGFHFPLRYFVYIGITAIVRLIIVDHKSPLDVLIYSAAILLLVITLWLCNSKRLKRE	PSIE_ECOLI	B
C6EAE8_ECOBD	MSKLKISPELLQISPEVQEALKNKKPVVALESTIISHGMPFPQNAQTAIEVEETIRKQGAVPATIAIIGGVMKVGLSKEEIELLGREGHNVTKVSRRDLPFVVAAGKNGATTVASTMIIAALAGIKVFATGGIGGVHRGAEHTFDISADLQELANTNVTVVCAGAKSILDLGLTTEYLETFGVPLIGYQTKALPAFFCRTSSFDVSIRLDSASEIARAMAVKWQSGLNGGLV	PSUG_ECOLI	B
C6EAE9_ECOBD	MDIMRSVVGMVVLLAIAFLLSVNKKSISLRTVGAALLLQIAIGGIMLYFPPGKWAVEQAALGVHKVMSYSDAGSAFIFGSLVGPKMDVLFDGAGFIFAFRVLPAIIFVTALISLLYYIGVMGLLIRILGSIFQKALNISKIESFVAVTTIFLRQNEIPAIVKPFIDRMNRNELFTAICSGMASIAGSMMIGYAGMGVPIDYLLAASLMAIPGGILFARILSPATEPSQVTFE	PSUT_ECOLI	B
C6EL82_ECOBD	MAIKKRSATVVPGASGAAAAVKNPQASKTSFWGELPQHVMSGISRMVPTLIMGGVILAFSQLIAYSWLKIPAEIGIMDALNSGKFSGFDLSLLKFAWLSQSFGGVLFGFAIPMFAAFVANSIGGKLAFPAGFIGGLMSTQPTQLLNFDPSTMQWATSSPVPSTFIGALIISIVAGYLVKWMNQKIQLPDFLLAFKTTFLLPILSAIFVMLAMYYVITPFGGWINGGIRTVLT	PTFC1_ECOLI	B
C6EE60_ECOBD	MNELVQILKNTRQHLMTGVSHMIPFVVSGGILLAVSVMLYGKGAVPDAVADPNLKKLFDIGVAGLTLMVPFLAAYIGYSIAERSALAPCAIGAWVGNSFGAGFFGALIAGIIGGIVVHYLKKIPVHKVLRSVMPIFIIPIVGTLITAGIMMWGLGEPVGALTNSLTQWLQGMQQGSIVMLAVIMGLMLAFDMGGPVNKVAYAFMLICVAQGVYTVVAIAAVGICIPPLGMGL	PTFC2_ECOLI	B
C6EF00_ECOBD	MESSLRIVAITNCPAGIAHTYMVAEALEQKARSLGHTIKVETQGSSGVENRLSSEEIAAADYVILATGRGLSGDDRARFAGKKVYEIAISQALKNIDQIFSELPTNSQLFAADSGVKLGKQEVQSGSVMSHLMAGVSAALPFVIGGGILVALANMLVQFGLPYTDMSKGAPSFTWVVESIGYLGFTFMIPIMGAYIASSIADKPAFAPAFLVCYLANDKALLGTQSGAGFLG	PTFLB_ECOLI	B
C6EJS8_ECOBD	MTHIRIEKGTGGWGGPLELETTPGKKIVYITAGTRPAIVDKLAQLTGWQAIDGFKEGEPAEAEIGVAVIDCGGTLRCGIYPKRRIPTINIHSTGKSGPLAQYIVEDIYVSGVKEENITVVGDATPQPSSVGRDYDTSKKITEQSDGLLAKVGMGMGSAVAVLFQSGRDTIDTVLKTILPFMAFVSALIGIIMASGLGDWIAHGLAPLASHPLGLVMLALICSFPLLSPFLGP	PTHB_ECOLI	B
C6EJS9_ECOBD	MIETITHGAEWFIGLFQKGGEVFTGMVTGILPLLISLLVIMNALINFIGQHRIERFAQRCAGNPVSRYLLLPCIGTFVFCNPMTLSLGRFMPEKYKPSYYAAASYSCHSMNGLFPHINPGELFVYLGIASGLTTLNLPLGPLAVSYLLVGLVTNFFRGWVTDLTTAIFEKKMGIQLEQKVHLAGATS	PTHC_ECOLI	B
C6EJR6_ECOBD	MAKNYAALARSVIAALGGVDNISAVTHCMTRLRFVIKDDALIDSPTLKTISGVLGVVRSDNQCQVIIGNTVSQAFQEVVSLLPGDMQPALPVGKPKLTLRRIGAGILDALIGTMSPLIPAIIGGSMVKLLAMILEMSGVLTKGSPTLTILNVIGDGAFFFLPLMVAASAAIKFKTNMSLAIAIAGVLVHPSFIELMAKAAQGEHVEFALIPVTAVKYTYTVIPALVMTWCLS	PTIBC_ECOLI	B
C6EIH7_ECOBD	MENKSARAKVQAFGGFLTAMVIPNIGAFIAWGFITALFIPTGWLPNEHFAKIVGPMITYLLPVMIGSTGGHLVGGKRGAVMGGIGTIGVIVGAEIPMFLGSMIMGPLGGLVIKYVDKALEKRIPAGFEMVINNFSLGIAGMLLCLLGFEVIGPAVLIANTFVKECIEALVHAGYLPLLSVINEPAKVLFLNNAIDQGVYYPLGMQQASVNGKSIFFMVASNPGPGLGLLLAF	PTMCB_ECOLI	B
C6EDM6_ECOBD	MTAKTAPKVTLWEFFQQLGKTFMLPVALLSFCGIMLGIGSSLSSHDVITLLPVLGNPVLQAIFTWMSKIGSFAFSFLPVMFCIAIPLGLARENKGVAAFAGFVGYAVMNLAVNFWLTNKGILPTTDTAVLKANNIQSILGIQSIDTGILGAVIAGIIVWMLHERFHNIRLPDALAFFGGTRFVPIISSLVMGLVGLVIPLVWPIFAMGISGLGHMINSAGDLGPMLFGTGER	PTOCB_ECOLI	B
C6EH86_ECOBD	MHEITLLQGLSLAALVFVLGIDFWLEALFLFRPIIVCTLTGAILGDIQTGLITGGLTELAFAGLTPAGGVQPPNPIMAGLMTTVIAWSTGVDAKTAIGLGLPFSLLMQYVILFFYSAFSLFMTKADKCAKEADTAAFSRLNWTTMLIVASAYAVIAFLCTYLAQGAMQALVKAMPAWLTHGFEVAGGILPAVGFGLLLRVMFKAQYIPYLIAGFLFVCYIQVSNLLPVAVLG	PTPC1_ECOLI	B
C6EH93_ECOBD	MEISLLQAFALGIIAFIAGLDMFNGLTHMHRPVVLGPLVGLVLGDLHTGILTGGTLELVWMGLAPLAGAQPPNVIIGTIVGTAFAITTGVKPDVAVGVAVPFAVAVQMGITFLFSVMSGVMSRCDRMAENADTRGIERVNYLALLALGTFYFLCAFLPIYFGAEHAKTIIDVLPQRLIDGLGVAGGIMPAIGFAVLLKIMMKNVYIPYFILGFVAAAWLKLPVLAIAAAALA	PTPC2_ECOLI	B
C6EH85_ECOBD	MGSEISKKDITRLGFRSSLLQASFNYERMQAGGFTWAMLPILKKIYKDDKPGLSAAMKDNLEFINTHPNLVGFLMGLLISMEEKGENRDTIKGLKVALFGPIAGIGDAIFWFTLLPIMAGICSSFASQGNLLGPILFFAVYLLIFFLRVGWTHVGYSVGVKAIDKVRENSQMIARSATILGITVIGGLIASYVHINVVTSFAIDSTHSVALQQDFFDKVFPNILPMAYTLLM	PTPD_ECOLI	B
C6ECM1_ECOBD	MSNVIASLEKVLLPFAVKIGKQPHVNAIKNGFIRLMPLTLAGAMFVLINNVFLSFGEGSFFYSLGIRLDASTIETLNGLKGIGGNVYNGTLGIMSLMAPFFIGMALAEERKVDALAAGLLSVAAFMTVTPYSVGEAYAVGANWLGGANIISGIIIGLVVAEMFTFIVRRNWVIKLPDSVPASVSRSFSALIPGFIILSVMGIIAWALNTWGTNFHQIIMDTISTPLASLGSV	PTQC_ECOLI	B
C6EFT6_ECOBD	MAINSPLNIAAQPGKTRLRKSLKLWQVVMMGLAYLTPMTVFDTFGIVSGISDGHVPASYLLALAGVLFTAISYGKLVRQFPEAGSAYTYAQKSINPHVGFMVGWSSLLDYLFLPMINVLLAKIYLSALFPEVPPWVWVVTFVAILTAANLKSVNLVANFNTLFVLVQISIMVVFIFLVVQGLHKGEGVGTVWSLQPFISENAHLIPIITGATIVCFSFLGFDAVTTLSEETP	PUUP_ECOLI	B
C6EFZ3_ECOBD	MDAKQTRQGVLLALAAYFIWGIAPAYFKLIYYVPADEILTHRVIWSFFFMVVLMSICRQWSYLKTLIQTPQKIFMLAVSAVLIGGNWLLFIWAVNNHHMLEASLGYFINPLVNIVLGMIFLGERFRRMQWLAVILAICGVLVQLWTFGSLPIIALGLAFSFAFYGLVRKKIAVEAQTGMLIETMWLLPVAAIYLFAIADSSTSHMGQNPMSLNLLLIAAGIVTTVPLLCFTA	RARD_ECOLI	B
C6EG52_ECOBD	MTTQTVSGRRYFTKAWLMEQKSLIALLVLIAIVSTLSPNFFTINNLFNILQQTSVNAIMAVGMTLVILTSGIDLSVGSLLALTGAVAASIVGIEVNALVAVAAALALGAAIGAVTGVIVAKGRVQAFIATLVMMLLLRGVTMVYTNGSPVNTGFTENADLFGWFGIGRPLGVPTPVWIMGIVFLAAWYMLHHTRLGRYIYALGGNEAATRLSGINVNKIKIIVYSLCGLLAS	RBSC_ECOLI	B
C6EJX7_ECOBD	MLAQLTISNFAIVRELEIDFHSGMTVITGETGAGKSIAIDALGLCLGGRAEADMVRTGAARADLCARFSLKDTPAALRWLEENQLEDGHECLLRRVISSDGRSRGFINGTAVPLSQLRELGQLLIQIHGQHAHQLLTKPEHQKFLLDGYANETSLLQEMTARYQLWHQSCRDLAHHQQLSQERAARAELLQYQLKELNEFNPQPGEFEQIDEEYKRLANSGQLLTTSQNALA	RECN_ECOLI	B
C6EK22_ECOBD	MEGWQRAFVLHSRPWSETSLMLDVFTEESGRVRLVAKGARSKRSTLKGALQPFTPLLLRFGGRGEVKTLRSAEAVSLALPLSGITLYSGLYINELLSRVLEYETRFSELFFDYLHCIQSLAGVTGTPEPALRRFELALLGHLGYGVNFTHCAGSGEPVDDTMTYRYREEKGFIASVVIDNKTFTGRQLKALNAREFPDADTLRAAKRFTRMALKPYLGGKPLKSRELFRQFM	RECO_ECOLI	B
C6E9V4_ECOBD	MSTALLDAVVKKNRVRLIPFMLALYVLAFLDRSNIGFAKQTYQIDTGLSNEAYALGAGIFFVVYAFLGVPANLLMRKLGARTWIGTTTLLWGFLSAAMAWADTEAKFLIVHTLLGAAEAGFFPGMIYLTSQWFPQRNRASIMGLFYMGAPLALTLGSPLSGALLEMHGFMGHPGWFWMFVIEGLLAVGAGVFTFFWLDDTPEQARFLSKQEKTLLINQLASEEQQKVTSRLS	RHMT_ECOLI	B
C6EJU9_ECOBD	MKLSRISAINWNKISDDKDLEVWNRLTSNFWLPEKVPLSNDIPAWQTLTVVEQQLTMRVFTGLTLLDTLQNVIGAPSLMPDALTPHEEAVLSNISFMEAVHARSYSSIFSTLCQTKDVDAAYAWSEENAPLQRKAQIIQQHYRGDDPLKKKIASVFLESFLFYSGFWLPMYFSSRGKLTNTADLIRLIIRDEAVHGYYIGYKYQKNMEKISLGQREELKSFAFDLLLELYDN	RIR4_ECOLI	B
C6EDR8_ECOBD	MKSILIEKPNQLAIVEREIPTPSAGEVRVKVKLAGICGSDSHIYRGHNPFAKYPRVIGHEFFGVIDAVGEGVESARVGERVAVDPVVSCGHCYPCSIGKPNVCTTLAVLGVHADGGFSEYAVVPAKNAWKIPEAVADQYAVMIEPFTIAANVTGHGQPTENDTVLVYGAGPIGLTIVQVLKGVYNVKNVIVADRIDERLEKAKESGADWAINNSQTPLGEIFTEKGIKPTLI	RSPB_ECOLI	B
C6EHK1_ECOBD	MAMFGLPHWQLKSTSTESGVVAPDERLPFAQTAIMGVQHAVAMFGATVLMPILMGLDPNLSILMSGIGTLLFFFITGGRVPSYLGSSAAFVGVVIAATGFNGQGINPNISIALGGIIACGLVYTVIGLVVMKIGTRWIERLMPPVVTGAVVMAIGLNLAPIAVKSVSASAFDSWMAVMTVLCIGLVAVFTRGMIQRLLILVGLIVACLLYGVMTNVLGLGKAVDFTLVSHAA	RUTG_ECOLI	B
C6EAY4_ECOBD	MIWIMTMARRMNGVYAAFMLVAFMMGVAGALQAPTLSLFLSREVGAQPFWIGLFYTVNAIAGIGVSLWLAKRSDSQGDRRKLIIFCCLMAIGNALLFAFNRHYLTLITCGVLLASLANTAMPQLFALAREYADNSAREVVMFSSVMRAQLSLAWVIGPPLAFMLALNYGFTVMFSIAAGIFTLSLVLIAFMLPSVARVELPSENALSMQGGWQDSNVRMLFVASTLMWTCNT	SETA_ECOLI	B
C6EA28_ECOBD	MHNSPAVSSAKSFDLTSTAFLIVAFLTGIAGALQTPTLSIFLTDEVHARPAMVGFFFTGSAVIGILVSQFLAGRSDKRGDRKSLIVFCCLLGVLACTLFAWNRNYFVLLFVGVFLSSFGSTANPQMFALAREHADKTGREAVMFSSFLRAQVSLAWVIGPPLAYALAMGFSFTVMYLSAAVAFIVCGVMVWLFLPSMQKELPLATGTIEAPRRNRRDTLLLFVICTLMWGSN	SETB_ECOLI	B
C6EDB2_ECOBD	MQKTATTPSKILDLTAAAFLLVAFLTGIAGALQTPTLSIFLADELKARPIMVGFFFTGSAIMGILVSQFLARHSDKQGDRKLLILLCCLFGVLACTLFAWNRNYFILLSTGVLLSSFASTANPQMFALAREHADRTGRETVMFSTFLRAQISLAWVIGPPLAYELAMGFSFKVMYLTAAIAFVVCGLIVWLFLPSIQRNIPVVTQPVEILPSTHRKRDTRLLFVVCSMMWAA	SETC_ECOLI	B
C6EHL7_ECOBD	MRRWISQNNIRLPRGAFFISALFFFNAVCIVSDNLLIIESFGEMAYNISYLTRVPGTNTLLACCCLLRPEEVNSEY	SFA_ECOLI	B
C6EGQ3_ECOBD	MTSFSTLLSVHLISIALSVGLLTLRFWLRYQKHPQAFARWTRIVPPVVDTLLLLSGIALMAKAHILPFSGQAQWLTEKLFGVIIYIVLGFIALDYRRMHSQQARIFAFPLALVVLYIIIKLATTKVPLLG	SIRB2_ECOLI	B
C6EDW1_ECOBD	MTTNTVSRKVAWLRVVTLAVAAFIFNTTEFVPVGLLSDIAQSFHMQTAQVGIMLTIYAWVVALMSLPFMLMTSQVERRKLLICLFVVFIASHVLSFLSWSFTVLVISRIGVAFAHAIFWSITASLAIRMAPAGKRAQALSLIATGTALAMVLGLPLGRIVGQYFGWRMTFFAIGIGALITLLCLIKLLPLLPSEHSGSLKSLPLLFRRPALMSIYLLTVVVVTAHYTAYSYI	SOTB_ECOLI	B
C6EI48_ECOBD	MATPVKKWLLRVAPWFLPVGIVAVWQLASSVGWLSTRILPSPEGVVTAFWTLSASGELWQHLAISSWRALIGFSIGGSLGLILGLISGLSRWGERLLDTSIQMLRNVPHLALIPLVILWFGIDESAKIFLVALGTLFPIYINTWHGIRNIDRGLVEMARSYGLSGIPLFIHVILPGALPSIMVGVRFALGLMWLTLIVAETISANSGIGYLAMNAREFLQTDVVVVAIILYA	SSUC_ECOLI	B
C6ECX5_ECOBD	MSWIILVIAGLLEVVWAVGLKYTHGFSRLTPSVITVTAMIVSMALLAWAMKSLPVGTAYAVWTGIGAVGAAITGIVLLGESANPMRLASLALIVLGIIGLKLSTQ	SUGE_ECOLI	B
C6ELL7_ECOBD	MSVLINEKLHSHRLKWRWPLSRQVTLSIGTLAVLLTVWWAVAALQLISPLFLPPPQQVLAKLLTIAGPQGFMDATLWQHLAASLTRIVLALLAAVVIGIPVGIAMGLSPTVRGILDPIIELYRPVPPLAYLPLMVIWFGIGENSKILLIYLAIFAPVAMSALAGVKSVQQVRIRAARSLGASRAQVLWFVILPGALPEILTGLRIGLGVGWSTLVAAELIAATRGLGFMVQS	TAUC_ECOLI	B
C6EHA8_ECOBD	MSTSDSIVSSQTKQSSWRKSDTTWTLGLFGTAIGAGVLFFPIRAGFGGLIPILLMLVLAYPIAFYCHRALARLCLSGSNPSGNITETVEEHFGKTGGVVITFLYFFAICPLLWIYGVTITNTFMTFWENQLGFAPLNRGFVALFLLLLMAFVIWFGKDLMVKVMSYLVWPFIASLVLISLSLIPYWNSAVIDQVDLGSLSLTGHDGILITVWLGISIMVFSFNFSPIVSSFV	TDCC_ECOLI	B
C6EHB2_ECOBD	MISAFDIFKIGIGPSSSHTVGPMNAGKSFIDRLESSGLLTATSHIVVDLYGSLSLTGKGHATDVAIIMGLAGNSPQDVVIDEIPAFIELVTRSGRLPVASGAHIVDFPVAKNIIFHPEMLPRHENGMRITAWKGQEELLSKTYYSVGGGFIVEEEHFGLSHDVETSVPYDFHSAGELLKMCDYNGLSISGLMMHNELALRSKAEIDAGFARIWQVMHDGIERGMNTEGVLPG	TDCG_ECOLI	B
C6EHA7_ECOBD	MHITYDLPVAIDDIIEAKQRLAGRIYKTGMPRSNYFSERCKGEIFLKFENMQRTGSFKIRGAFNKLSSLTDAEKRKGVVACSAGNHAQGVSLSCAMLGIDGKVVMPKGAPKSKVAATCDYSAEVVLHGDNFNDTIAKVSEIVEMEGRIFIPPYDDPKVIAGQGTIGLEIMEDLYDVDNVIVPIGGGGLIAGIAVAIKSINPTIRVIGVQSENVHGMAASFHSGEITTHRTTG	THD2_ECOLI	B
C6EE24_ECOBD	MSATKLTRREQRAQAQHFIDTLEGTAFPNSKRIYITGTQPGVRVPMREIQLSPTLIGGSKEQPQYEENEAIPAYDTSGPYGDPQIAINVQQGLAKLRQPWIDARGDTEELTVRSSDYTKARLADDGLDELRFSGLLTPKRAKTGRRVTQLHYARQGIITPEMEFIAIRENMGRERIRSEVLRHQHPGMSFGARLPENITAEFVRDEVAAGRAIIPANINHPESEPMIIGRNF	THIC_ECOLI	B
C6EGY6_ECOBD	MPFRSNNPITRDELLSRFFPQFHHVTTFNSGLSGGSFLIEHQGQRFVVRQPHDPDAPQSAFLRQYRALSQLPACIAPKPHLYLRDWMVVDYLPGAVKTYLPDTNELAGLLYYLHQQPRFGWRITLLPLLELYWQQSDPARRTVGWLRMLKRLRKAREPRPLRLSPLHMDVHAGNLVHSASGLKLIDWEYAGDGDIALELAAVWVENTEQHLQLVNDYATRAKIYPAQLWRQV	THIK_ECOLI	B
C6EAK6_ECOBD	MQVDLLGSAQSAHALHLFHQHSPLVHCMTNDVVQTFTANTLLALGASPAMVIETEEASQFAAIASALLINVGTLTQPRAQAMRAAVEQAKSSQTPWTLDPVAVGALDYRRHFCHELLSFKPAAIRGNASEIMALAGIANGGRGVDTTDAAANAIPAAQTLARETGAIVVVTGEMDYVTDGHRIIGIHGGDPLMTKVVGTGCALSAVVAACCALPGDTLENVASACHWMKQAG	THIM_ECOLI	B
C6EAY8_ECOBD	MATRRQPLIPGWLIPGVSATTLVVAVALAAFLALWWNAPQDDWVAVWQDSYLWHVVRFSFWQAFLSALLSVVPAIFLARALYRRRFPGRLALLRLCAMTLILPVLVAVFGILSVYGRQGWLATLCQSLGLEWTFSPYGLQGILLAHVFFNLPMASRLLLQALENIPGEQRQLAAQLGMRGWHFFRFVEWPWLRRQIPPVAALIFMLCFASFATVLSLGGGPQATTIELAIYQ	THIP_ECOLI	B
C6EG94_ECOBD	MTDQAEKKHSAFWGVMVIAGTVIGGGMFALPVDLAGAWFFWGAFILIIAWFSMLHSGLLLLEANLNYPVGSSFNTITKDLIGNTWNIISGITVAFVLYILTYAYISANGAIISETISMNLGYHANPRIVGICTAIFVASVLWISSLAASRITSLFLGLKIISFVIVFGSFFFQVDYSILRDATSTTAGTSYFPYIFMALPVCLASFGFHGNIPSLIICYGKRKDKLIKSVVF	TNAB_ECOLI	B
C6EHL4_ECOBD	MALLTLTSTLVGWYNLRFISQVEKDNTQALIPTMNMARQLSEASAWELFAAQNLTSADNEKMWQAQGRMLTAQSLKINALLQALREQGFDTTAIEQQEQEISRSLRQQGELVGQRLQLRQQQQQLSQQIVAAADEIARLAQGQANNATTSAGATQAGIYDLIEQDQRQAAESALDRLIDIDLEYVNQMNELRLSALRVQQMMMNLGLEQIQKNAPTLEKQLNNAVKILQRRQ	TORS_ECOLI	B
C6EBV4_ECOBD	MRGKKRIGLLFLLIAVVVGGGGLLLAQKALHKTSDTAFCLSCHSMSKPFEEYQGTVHFSNQKGIRAECADCHIPKSGMDYLFAKLKASKDIYHEFVSGKIDSDDMFETHRQEMAETVWKELKATDSATCRSCHSFDAMDIASQSESAQKMHNKAQKGGETCIDCHKGIAHFPPEIKMDDNAAHELESQTATSVTNGAHIYPFKTSRIGELATVNPGTDLTVVDASGKQPIVL	TORY_ECOLI	B
C6EFL2_ECOBD	MTNSNRIKLTWISFLSYALTGALVIVTGMVMGNIADYFNLPVSSMSNTFTFLNAGILISIFLNAWLMEIVPLKTQLRFGFLLMVLAVAGLMFSHSLALFSTAMFILGVVSGITMSIGTFLITQMYEGRQRGSRLLFTDSFFSMAGMIFPMIAAFLLARSIEWYWVYACIGLVYVAIFILTFGCEFPALGKHAPKTDAPVEKEKWGIGVLFLSVAALCYILGQLGFISWVPEY	TSGA_ECOLI	B
C6EHT5_ECOBD	MLNSWPLAKDLQVLVEIVHSGSFSAAAATLGQTPAFVTKRIQILENTLATTLLNRSARGVALTESGQRCYEHALEILTQYQRLVDDVTQIKTRPEGMIRIGCSFGFGRSHIAPAITELMRNYPELQVHFELFDRQIDLVQDNIDLDIRINDEIPDYYIAHLLTKNKRILCAAPEYLQKYPQPQSLQELSRHDCLVTKERDMTHGIWELGNGQEKKSVKVSGHLSSNSGEIVL	TTDR_ECOLI	B
C6EHT2_ECOBD	MKPSTEWWRYLAPLAVIAIIALLPVPAGLENHTWLYFAVFTGVIVGLILEPVPGAVVAMVGISIIAILSPWLLFSPEQLAQPGFKFTAKSLSWAVSGFSNSVIWLIFAAFMFGTGYEKTGLGRRIALILVKKMGHRTLFLGYAVMFSELILAPVTPSNSARGAGIIYPIIRNLPPLYQSQPNDSSSRSIGSYIMWMGIVADCVTSAIFLTAMAPNLLLIGLMKSASHATLSW	TTDT_ECOLI	B
C6EBF2_ECOBD	MKNRTLGSVFIVAGTTIGAGMLAMPLAAAGVGFSVTLILLIGLWALMCYTALLLLEVYQHVPADTGLGTLAKRYLGRYGQWLTGFSMMFLMYALTAAYISGAGELLASSISDWTGISMSATAGVLLFTFVAGGVVCVGTSLVDLFNRFLFSAKIIFLVVMLVLLLPHIHKVNLLTLPLQQGLALSAIPVIFTSFGFHGSVPSIVSYMDGNIRKLRWVFIIGSAIPLVAYIFW	TYRP_ECOLI	B
C6EDA2_ECOBD	MLPFLKAPADAPLMTDKYEIDARYRYWRRHILLTIWLGYALFYFTRKSFNAAVPEILANGVLSRSDIGLLATLFYITYGVSKFVSGIVSDRSNARYFMGIGLIATGIINILFGFSTSLWAFAVLWVLNAFFQGWGSPVCARLLTAWYSRTERGGWWALWNTAHNVGGALIPIVMAAAALHYGWRAGMMIAGCMAIVVGIFLCWRLRDRPQALGLPAVGEWRHDALEIAQQQE	UHPC_ECOLI	B
C6EDA3_ECOBD	MLAFLNQVRKPTLDLPLEVRRKMWFKPFMQSYLVVFIGYLTMYLIRKNFNIAQNDMISTYGLSMTQLGMIGLGFSITYGVGKTLVSYYADGKNTKQFLPFMLILSAICMLGFSASMGSGSVSLFLMIAFYALSGFFQSTGGSCSYSTITKWTPRRKRGTFLGFWNISHNLGGAGAAGVALFGANYLFDGHVIGMFIFPSIIALIVGFIGLRYGSDSPESYGLGKAEELFGEE	UHPT_ECOLI	B
C6EDN1_ECOBD	MNQQLSWRTIVGYSLGDVANNFAFAMGALFLLSYYTDVAGVGAAAAGTILLLVRVFDAFADVFAGRVVDSVNTRWGKFRPFLLFGTAPLMIFSVLVFWVPTDWSHSSKVVYAYLTYMGLGLCYSLVNIPYGSLATAMTQQPQSRARLGAARGIAASLTFVCLAFLIGPSIKNSSPEEMVSVYHFWTIVLAIAGMVLYFICFKSTRENVVRIVAQPSLNISLQTLKRNRPLFM	UIDB_ECOLI	B
C6ECF6_ECOBD	MEILYNIFTVFFNQVMTNAPLLLGIVTCLGYILLRKSVSVIIKGTIKTIIGFMLLQAGSGILTSTFKPVVAKMSEVYGINGAISDTYASMMATIDRMGDAYSWVGYAVLLALALNICYVLLRRITGIRTIMLTGHIMFQQAGLIAVTLFIFGYSMWTTIICTAILVSLYWGITSNMMYKPTQEVTDGCGFSIGHQQQFASWIAYKVAPFLGKKEESVEDLKLPGWLNIFHDN	ULAA_ECOLI	B
C6EKL4_ECOBD	MTRRAIGVSERPPLLQTIPLSLQHLFAMFGATVLVPVLFHINPATVLLFNGIGTLLYLFICKGKIPAYLGSSFAFISPVLLLLPLGYEVALGGFIMCGVLFCLVSFIVKKAGTGWLDVLFPPAAMGAIVAVIGLELAGVAAGMAGLLPAEGQTPDSKTIIISITTLAVTVLGSVLFRGFLAIIPILIGVLVGYALSFAMGIVDTTPIINAHWFALPTLYTPRFEWFAILTIL	URAA_ECOLI	B
C6EEJ1_ECOBD	MISTVALFWALCVVCIVNMARYFSSLRALLVVLRNCDPLLYQYVDGGGFFTSHGQPNKQVRLVWYIYAQRYRDHHDDEFIRRCERVRRQFILTSALCGLVVVSLIALMIWH	USPB_ECOLI	B
C6EHQ3_ECOBD	MQYIKIHALDNVAVALADLAEGTEVSVDNQTVRLRQDVARGHKFALTNIAKGANVIKYGLPIGYALADIAAGEHVHAHNTRTNLSDLDQYRYQPDFQDLPAQAADREVQIYRRANGDVGVRNELWILPTVGCVNGIARQIQNRFLKETNNAEGTDGVFLFSHTYGCSQLGDDHINTRTMLQNMVRHPNAGAVLVIGLGCENNQVAAFRETLGDIDPERVHFMICQQQDDEIE	UXAA_ECOLI	B
C6ECL6_ECOBD	MEYFDMRKMSVNLWRNAAGETREICTFPPAKRDFYWRASIASIAANGEFSLFPGMERIVTLLEGGEMLLESADRFNHTLKPFQPFAFAADQVVKAKLTAGQMSMDFNIMTRLDVCKAKVRIAERTFTTFGSRGGVVFVINGAWQLGDKLLTTDQGACWFDGRHTLRLLQPQGKLLFSEINWLAGHSPDQVQ	VES_ECOLI	B
C6EAQ1_ECOBD	MSTSIRICSYLLLPLIYLLVNVKIAQLGESFPITIVTFLPVLLLLFLERISVKKLMIALGIGAGLTAFNYLFGQSLDASKYVTSTMLFVYIVIIIGMVWSIRFKTISPHNHRKILRFFYLVVGLVVALAAVEMAQIILTGGSSIMESISKYLIYSNSYVLNFIKFGGKRTTALYFEPAFFALALISIWLSIKQFGIKTPKTDAMILAGIILSGSFSGVMTFILFYLLEWAFQ	WCAD_ECOLI	B
C6EAQ7_ECOBD	MKILVYGINYSPELTGIGKYTGEMVEWLAAQGHEVRVITAPPYYPQWQVGENYSAWRYKREEGAATVWRCPLYVPKQPSTLKRLLHLGSFAVSSFFPLMAQRRWKPDRIIGVVPTLFCTPGMRLLAKLSGARTVLHIQDYEVDAMLGLGLAGKGKGGKVAQLATAFERSGLHNVDNVSTISRSMMNKAIEKGVAADNIIFFPNWSEIARFQHVADADVDALRNQLGLPDNKK	WCAI_ECOLI	B
C6EAR0_ECOBD	MTNLKKRERAKTNASLISMVQRFSDITIMFAGLWLVCEVSGLSFLYMHLLVALITLVVFQMLGGITDFYRSWRGVRAATEFALLLQNWTLSVIFSAGLVAFNNDFDTQLKIWLAWYGLTSIGLVVCRSCIRIGAGWLRNHGYNKRMVAVAGDLAAGQMLMESFRNQPWLGFEVVGVYHDPKPGGVSNDWAGNLQQLVEDAKAGKIHNVYIAMQMCDGARVKKLVHQLADTTC	WCAJ_ECOLI	B
C6EAP7_ECOBD	MTEKVKQHAAPVTGSDEIDIGRLVGTVIEARWWVIGITAVFALCAVVYTFFATPIYSADALVQIEQNSGNSLVQDIGSALANKPPASDAEIQLIRSRLVLGKTVDDLDLDIAVSKNTFPIFGAGWDRLMGRQNETVKVTTFNRPKEMADQVFTLNVLDNKNYTLSSDGGFSARGQAGQMLKKEGVTLMVEAIHARPGSEFTVTKYSTLGMINQLQNSLTVTENGKDAGVLSL	WZC_ECOLI	B
C6EAR1_ECOBD	MSLREKTISGAKWSAIATVIIIGLGLVQMTVLARIIDNHQFGLLTVSLVIIALADTLSDFGIANSIIQRKEISHLELTTLYWLNVGLGLVVCVAVFLLSDLIGDVLNNPDLAPLIKTLSLAFVVIPHGQQFRALMQKELEFNKIGMIETSAVLAGFTFTVVSAHFWPLAMTAILGYLVNSAVRTLLFGYFGRKIYRPGLHFSLASVAPNLRFGAWLTADSIINYLNTNLSTL	WZXC_ECOLI	B
C6EG20_ECOBD	MSLAKASLWTAASTLVKIGAGLLVGKLLAVSFGPAGLGLAANFRQLITVLGVLAGAGIFNGVTKYVAQYHDNPQQLRRVVGTSSAMVLGFSTLMALVFVLAAAPISQGLFGNTDYQGLVRLVALVQMGIAWGNLLLALMKGFRDAAGNALSLIVGSLIGVLAYYVSYRLGGYEGALLGLALIPALVVIPAAIMLIKRGVIPLSYLKPSWDNGLAGQLSKFTLMALITSVTLP	WZXE_ECOLI	B
C6EG18_ECOBD	MSLLQFSGLFVVWLLCTLFIATLTWFEFRRVRFNFNVFFSLLFLLTFFFGFPLTSVLVFRFDVGVAPPEILLQALLSAGCFYAVYYVTYKTRLRKRVADVPRRPLFTMNRVETNLTWVILMGIALVSVGIFFMHNGFLLFRLNSYSQIFSSEVSGVALKRFFYFFIPAMLVVYFLRQDSKAWLFFLVSTVAFGLLTYMIVGGTRANIIIAFAIFLFIGIIRGWISLWMLAAA	WZYE_ECOLI	B
C6EDD5_ECOBD	MSVSTLESENAQPVAQTQNSELIYRLEDRPPLPQTLFAACQHLLAMFVAVITPALLICQALGLPAQDTQHIISMSLFASGVASIIQIKAWGPVGSGLLSIQGTSFNFVAPLIMGGTALKTGGADVPTMMAALFGTLMLASCTEMVISRVLHLARRIITPLVSGVVVMIIGLSLIQVGLTSIGGGYAAMSDNTFGAPKNLLLAGVVLALIILLNRQRNPYLRVASLVIAMAAG	XANP_ECOLI	B
C6EIM6_ECOBD	MSDINHAGSDLIFELEDRPPFHQALVGAITHLLAIFVPMVTPALIVGAALQLSAETTAYLVSMAMIASGIGTWLQVNRYGIVGSGLLSIQSVNFSFVTVMIALGSSMKSDGFHEELIMSSLLGVSFVGAFLVVGSSFILPYLRRVITPTVSGIVVLMIGLSLIKVGIIDFGGGFAAKSSGTFGNYEHLGVGLLVLIVVIGFNCCRSPLLRMGGIAIGLCVSYIASLCLGMVD	XANQ_ECOLI	B
C6EDZ2_ECOBD	MNTQYNSSYIFSITLVATLGGLLFGYDTAVISGTVESLNTVFVAPQNLSESAANSLLGFCVASALIGCIIGGALGGYCSNRFGRRDSLKIAAVLFFISGVGSAWPELGFTSINPDNTVPVYLAGYVPEFVIYRIIGGIGVGLASMLSPMYIAELAPAHIRGKLVSFNQFAIIFGQLLVYCVNYFIARSGDASWLNTDGWRYMFASECIPALLFLMLLYTVPESPRWLMSRGK	XYLE_ECOLI	B
C6EEB1_ECOBD	MSKSNPSEVKLAVPTSGSFSGLKSLNLQVFVMIAAIIAIMLFFTWTTDGAYLSARNVSNLLRQTAITGILAVGMVFVIISAEIDLSVGSMMGLLGGVAAICDVWLGWPLPLTIIVTLVLGLLLGAWNGWWVAYRKVPSFIVTLAGMLAFRGILIGITNGTTVSPTSAAMSQIGQSYLPASTGFIIGALGLMAFVGWQWRGRMRRQALGLQSPASTAVVGRQALTAIIVLGAI	XYLH_ECOLI	B
C6EBG2_ECOBD	MPDFFSFINSVLWGSVMIYLLFGAGCWFTFRTGFVQFRYIRQFGKSLKNSIHPQPGGLTSFQSLCTSLAARVGSGNLAGVALAITAGGPGAVFWMWVAAFIGMATSFAECSLAQLYKERDANGQFRGGPAWYMARGLGMRWMGVLFAVFLLIAYGIIFSGIQANAVARALSFSFDFPPLVTGIILAVFALLAITRGLHGVARLMQGFVPLMAIIWVLTSLVICVMNIGQLPH	YAAJ_ECOLI	B
C6EB08_ECOBD	MQPSRNFDDLKFSSIHRRILLWGSGGPFLDGYVLVMIGVALEQLTPALKLDADWIGLLGAGTLAGLFVGTSLFGYISDKVGRRKMFLIDIIAIGVISVATMFVSSPVELLVMRVLIGIVIGADYPIATSMITEFSSTRQRAFSISFIAAMWYVGATCADLVGYWLYDVEGGWRWMLGSAAIPCLLILIGRFELPESPRWLLRKGRVKECEEMMIKLFGEPVAFDEEQPQQTR	YAAU_ECOLI	B
C6EAC7_ECOBD	MLVYWLDIVGTAVFAISGVLLAGKLRMDPFGVLVLGVVTAVGGGTIRDMALDHGPVFWVKDPTDLVVAMVTSMLTIVLVRQPRRLPKWMLPVLDAVGLAVFVGIGVNKAFNAEAGPLIAVCMGVITGVGGGIIRDVLAREIPMILRTEIYATACIIGGIVHATAYYTFSVPLETASMMGMVVTLLIRLAAIRWHLKLPTFALDENGR	YADS_ECOLI	B
C6ELR3_ECOBD	MNGLTATGVTVGICAGLWQLVSSHVGLSQGWELLGTIGFVAFCSFYAAGGGKSGFIRSLAVNYSGMVWAFFAALAAGWLASVSGLSAFWASVITTVPFSAVVVWQGRFWLLSFIPGGFLGMTLFFASGMNWTVTLLGFLAGNCVGIISEYGGQKLSEATTKRDGY	YAHC_ECOLI	B
C6ELQ2_ECOBD	MDPLHAVYLTVGLFVITFFNPGANLFVVVQTSLASGRRAGVLTGLGVALGDAFYSGLGLFGLATLITQCEEIFSLIRIVGGAYLLWFAWCSMRRQSTPQMSTLQQPISAPWYVFFRRGLITDLSNPQTVLFFISIFSVTLNAETPTWARLMAWAGIVLASIIWRVFLSQAFSLPAVRRAYGRMQRVASRVIGAIIGVFALRLIYEGVTQR	YAHN_ECOLI	B
C6ELK8_ECOBD	MADFTLSKSLFSGKYRNASSTPGNIAYALFVLFCFWAGAQLLNLLVHAPGVYERLMQVQETGRPRVEIGLGVGTIFGLIPFLVGCLIFAVVALWLHWRHRRQ	YAIY_ECOLI	B
C6ELK7_ECOBD	MNLPVKIRRDWHYYAFAIGLIFILNGVVGLLGFEAKGWQTYAVGLVTWVISFWLAGLIIRRRDEETENAQ	YAIZ_ECOLI	B
C6EKZ6_ECOBD	MQRIILIIIGWLAVVLGTLGVVLPVLPTTPFILLAAWCFARSSPRFHAWLLYRSWFGSYLRFWQKHHAMPRGVKPRAILLILLTFAISLWFVQMPWVRIMLLVILACLLFYMWRIPVIDEKQEKH	YBAN_ECOLI	B
C6EL16_ECOBD	MLDKIDRKLLALLQQDCTLSLQALAEAVNLTTTPCWKRLKRLEDDGILIGKVALLDPEKIGLGLTAFVLIKTQHHSSEWYCRFVTVVTEMPEVLGFWRMAGEYDYLMRVQVADMKRYDEFYKRLVNSVPGLSDVTSSFAMEQIKYTTSLPIE	YBAO_ECOLI	B
C6EKX8_ECOBD	MMNTEGNNGNKPLGLWNVVSIGIGAMVGAGIFALLGQAALLMEASTWVAFAFGGIVAMFSGYAYARLGASYPSNGGIIDFFRRGLGNGVFSLALSLLYLLTLAVSIAMVARAFGAYAVQFLHEGSQEEHLILLYALGIIAVMTLFNSLSNHAVGRLEVILVGIKMMILLLLIIAGVWSLQPAHISVSAPPSSGAFFSCIGITFLAYAGFGMMANAADKVKDPQVIMPRAFLV	YBAT_ECOLI	B
C6EKV3_ECOBD	MFNFAVSRESLLSGFQWFFFIFCNTVVVPPTLLSAFQLPQSSLLTLTQYAFLATALACFAQAFCGHRRAIMEGPGGLWWGTILTITLGEASRGTPINDIATSLAVGIALSGVLTMLIGFSGLGHRLARLFTPSVMVLFMLMLGAQLTTIFFKGMLGLPFGIADPNFKIQLPPFALSVAVMCLVLGMIIFLPQRFARYGLLVGTITGWLLWYFCFPSSHSLSGELHWQWFPLG	YBBY_ECOLI	B
C6EKT9_ECOBD	MPTVITHAAVPLCIGLGLGSKVIPPRLLFAGIILAMLPDADVLSFNFGVAYGNVFGHRGFTHSLVFAFVVPLLCVLIGRRWFRAGLIRCWLFLTVSLLSHSLLNSVTTGGKGVGWLWPWSDERFFAPWQVIKVAPFALSRYTTAYGHQVIISELMWVWLPGMLLMGMLWWRRR	YBCI_ECOLI	B
C6EKC1_ECOBD	MAFLSCLLLPAPALGLTLAQKLVSTFHLMDLSQLYTLLFCLWFLVLGAIEYFVLRFIWRRWFSLAD	YBDJ_ECOLI	B
C6EK86_ECOBD	MKALTYHGPHHVQVENVPDPGIEQADDIILRITATAICGSDLHLYRGKIPQVKHGDIFGHEFMGEVVETGKDVKNLQKGDRVVIPFVIACGDCFFCRLQQYAACENTNAGKGAALNKKQIPAPAALFGYSHLYGGVPGGQAEYVRVPKGNVGPFKVPPLLSDDKALFLSDILPTAWQAAKNAQIQQGSSVAVYGAGPVGLLTIACARLLGAEQIFVVDHHPYRLHFAADRYG	YBDR_ECOLI	B
C6EJN5_ECOBD	MELYREYPAWLIFLRRTYAVAAGVLALPFMLFWKDRARFYSYLHRVWSKTSDKPVWMDQAEKATGDFY	YBFA_ECOLI	B
C6EJN4_ECOBD	MKYIIFLFRAIWLALSLLILFFSMHRLSLLDSTRDVSELISLMSYGMMVICFPTGIVFFIALIFIGTVSDIIGVRIDSKYIMAIIIWLYFLSGGYIQWFVLSKRIINK	YBFB_ECOLI	B
C6EJK3_ECOBD	MWYFAWILGTLLACSFGVITALALEHVESGKAGQEDI	YBGT_ECOLI	B
C6EIZ5_ECOBD	MESYSKNSNKLDFQHEARILNGIWLITALGLVATAGLAWGAKYLEITATKYDSLPMYVAIGLLLLCMYGLSKDINKINAAIAGVIYLFLLSLVAIVVASLVPVYAIIIVFSTAGAMFLISMLAGLLFNVDPGSHRFIIMMTLTGLALVIIVNAALMSERPIWVISCLMIVLWSGIISHGRNKLLELAGKCHSEELWSPVRCAFIGALTLYYYFIGFFGILAAIAITLVWQRH	YBHM_ECOLI	B
C6EIZ4_ECOBD	MSKSHPRWRLAKKILTWLLFIAVIVLLVVYAKKVDWEEVWKVIRDYNRVALLSAVGLVVVSYLIYGCYDLLARFYCGHKLAKRQVMLVSFICYAFNLTLSTWVGGIGMRYRLYSRLGLPGSTITRIFSLSITTNWLGYILLAGIIFTAGVVELPDHWYVDQTTLRILGIGLLTIIAVYLWFCAFAKHRHMTIKGQKLVLPSWKFALAQMLISSVNWMVMGAIIWLLLGQSVN	YBHN_ECOLI	B
C6EIZ1_ECOBD	MKWQQRVRVATGLSCWQIMLHLLVVALLVVGWMSKTLVHVGVGLCALYCVTVVMMLVFQRHPEQRWREVADVLEELTTTWYFGAALIVLWLLSRVLENNFLLAIAGLAILAGPAVVSLLAKDKKLHHLTSKHRVRR	YBHQ_ECOLI	B
C6EIW4_ECOBD	MSLPFLRTLQGDRFFQLLILVGIGLSFFVPFAPKSWPAAIDWHTIITLSGLMLLTKGVELSGYFDVLGRKMVRRFATERRLAMFMVLAAALLSTFLTNDVALFIVVPLTITLKRLCEIPVNRLIIFEALAVNAGSLLTPIGNPQNILIWGRSGLSFAGFIAQMAPLAGAMMLTLLLLCWCCFPGKAMQYHTGVQTPEWKPRLVWSCLGLYIVFLTALEFKQELWGLVIVAAG	YBIR_ECOLI	B
C6EIQ5_ECOBD	MRAIGKLPKGVLILEFIGMMLLAVALLSVSDSLSLPEPFSRPEVQILMIFLGVLLMLPAAVVVILQVAKRLAPQLMNRPPQYSRSEREKDNDANH	YBJC_ECOLI	B
C6EIU2_ECOBD	MLENLNLSLFSLINATPDSAPWMISLAIFIAKDLITVVPLLAVVLWLWGLTAQRQLVIKIAIALAVSLFVSWTMGHLFPHDRPFVENIGYNFLHHAADDSFPSDHGTVIFTFALAFLCWHRLWSGSLLMVLAVVIAWSRVYLGVHWPLDMLGGLLAGMIGCLSAQIIWQAMGHKLYQRLQSWYRVCFALPIRKGWVRD	YBJG_ECOLI	B
C6EIT8_ECOBD	MTVNSSRNALKRRTWALFMFFFLPGLLMASWATRTPAIRDILSVSIAEMGGVLFGLSIGSMSGILCSAWLVKRFGTRNVILVTMSCALIGMMILSLALWLTSPLLFAVGLGVFGASFGSAEVAINVEGAAVEREMNKTVLPMMHGFYSLGTLAGAGVGMALTAFGVPATVHILLAALVGIAPIYIAIQAIPDGTGKNAADGTQHGEKGVPFYRDIQLLLIGVVVLAMAFAEG	YBJJ_ECOLI	B
C6EIQ7_ECOBD	MKHKQRWAGAICCFVLFIVVCLFLATHMKGAFRAAGHPEIGLLFFILPGAVASFFSQRREVLKPLFGAMLAAPCSMLIMRLFFSPTRSFWQELAWLLSAVFWCALGALCFLFISSLFKPQHRKNQ	YBJM_ECOLI	B
C6EIC3_ECOBD	MEDETLGFFKKTSSSHARLNVPALVQVAALAIIMIRGLDVLMIFNTLGVRGIGEFIHRSVQTWSLTLVFLSSLVLVFIEIWCAFSLVKGRRWARWLYLLTQITAASYLWAASLGYGYPELFSIPGESKREIFHSLMLQKLPDMLILMLLFVPSTSRRFFQLQ	YBJO_ECOLI	B
C6EI84_ECOBD	MSTYTQPVMLLLSGLLLLTLAIAVLNTLVPLWLAQEHMSTWQVGVVSSSYFTGNLVGTLLTGYVIKRIGFNRSYYLASFIFAAGCAGLGLMIGFWSWLAWRFVAGVGCAMIWVVVESALMCSGTSRNRGRLLAAYMMVYYVGTFLGQLLVSKVSTELMSVLPWVTGLTLAGILPLLFTRVLNQQAENHDSTSITSMLKLRQARLGVNGCIISGIVLGSLYGLMPLYLNHKGV	YCAD_ECOLI	B
C6EI69_ECOBD	MKITTVGVCIISGIFPLLILPQLPGTLTLAFLTLFACVLAFIPVKTVRYIALTLLFFVWGILSAKQILWAGETLTGATQDAIVEITATDGMTTHYGQITHLQGRRIFPASGLVMYGEYLPQAVCAGQQWSMKLKVRAVHGQLNDGGFDSQRYAIAQHQPLTGRFLQASVIEPNCSLRAQYLASLQTTLQPYPWNAVILGLGMGERLSVPKEIKNIMRDTGTAHLMAISGLHI	YCAI_ECOLI	B
C6EI81_ECOBD	MQSERIYLVWAHPRHDSLTAHIADAIHQRAMERKIQVTELDLYRRNFNPVMTPEDEPDWKNMDKRYSPEVHQLYSELLEHDTLVVVFPLWWYSFPAMLKGYIDRVWNNGLAYGDGHKLPFNKVRWVALVGGDKESFVQMGWEKNISDYLKNMCSYLGIEDADVTFLCNTVVFDGEELHASYYQSLLSQVRDMVDAL	YCAK_ECOLI	B
C6EI83_ECOBD	MAGNVQEKQLRWYNIALMSFITVWGFGNVVNNYANQGLVVVFSWVFIFALYFTPYALIVGQLGSTFKDGKGGVSTWIKHTMGPGLAYLAAWTYWVVHIPYLAQKPQAILIALGWAMKGDGSLIKEYSVVALQGLTLVLFIFFMWVASRGMKSLKIVGSVAGIAMFVMSLLYVAMAVTAPAITEVHIATTNITWETFIPHIDFTYITTISMLVFAVGGAEKISPYVNQTRNPG	YCAM_ECOLI	B
C6EI76_ECOBD	MKAFDLHRMAFDKVPFDFLGEVALRSLYTFVLVFLFLKMTGRRGVRQMSLFEVLIILTLGSAAGDVAFYDDVPMVPVLIVFITLALLYRLVMWLMAHSEKLEDLLEGKPVVIIEDGELAWSKLNNSNMTEFEFFMELRLRGVEQLGQVRLAILETNGQISVYFFEDDKVKPGLLILPSDCTQRYKVVPESADYACIRCSEIIHMKAGEKQLCPRCANPEWTKASRAKRVT	YCAP_ECOLI	B
C6EHM8_ECOBD	MWYLLWFVGILLMCSLSTLVLVWLDPRLKS	YCCB_ECOLI	B
C6EHL5_ECOBD	MAENKRTRWQRRPGTTGGKLPWNDWRNATTWRKATQLLLLAMNIYIAITFWYWVRYYETASSTTFVARPGGIEGWLPIAGLMNLKYSLVTGQLPSVHAAAMLLLVAFIVISLLLKKAFCSWLCPVGTLSELIGDLGNKLFGRQCVLPRWLDIPLRGVKYLLLSFFLYIALLMPAQAIHYFMLSPYSVVMDVKMLDFFRHMGTATLISVTVLLIASLFIRHAWCRYLCPYGAL	YCCM_ECOLI	B
C6EHI2_ECOBD	MEKDYLRISSTVLVSLLFGLALVLVNSWFNQPGVEEVVPRSTYLMVMIALFFIDTVAFIFMQLYFIYDRRQFSNCVLSLAFLSCLIYFVKTVIIIQQIIEERLTSSVVQNDIAIYYLFRQMSLCILIFLALVNKVSENTKQRNLFSKKMTLCISLFFVFGGPIVAHILSSHYESYNLHIAELTNENGQVVWKASYVTIMIFMWLTLLSVNLYFNGLRYDIWNGVTVIAFCAV	YCDT_ECOLI	B
C6EHH6_ECOBD	MAAFSAIMRGMNILLSIAITTGILSGIWGWVAVSLGLLSWAGFLGCTAYFACPQGGLKGLAISAATLLSGVVWAMVIIYGSALAPHLEILGYVITGIVAFLMCIQAKQLLLSFVPGTFIGACATFAGQGDWKLVLPSLALGLIFGYAMKNSGLWLAARSAKTAHREQEIKNKA	YCDZ_ECOLI	B
C6EHF5_ECOBD	MRRLLHYLINNIREHLMLYLFLWGLLAIMDLIYVFYF	YCEO_ECOLI	B
C6EGY2_ECOBD	MNKSMLAGIGIGVAAALGVAAVASLNVFERGPQYAQVVSATPIKETVKTPRQECRNVTVTHRRPVQDENRITGSVLGAVAGGVIGHQFGGGRGKDVATVVGALGGGYAGNQIQGSLQESDTYTTTQQRCKTVYDKSEKMLGYDVTYKIGDQQGKIRMDRDPGTQIPLDSNGQLILNNKV	YCFJ_ECOLI	B
C6EGX7_ECOBD	MKQKELWINQIKGLCICLVVIYHSVITFYPHLTTFQHPLSEVLSKCWIYFNLYLAPFRMPVFFFISGYLIRRYIDSVPWGNCLDKRIWNIFWVLALWGVVQWLALSALNQWLAPERDLSNASSAAYADSTGEFLHGMITASTSLWYLYALIVYFVICKIFSRLALPLFALFVLLSVAVNFVPTPWWGMNSVIRNLPYYSLGAWFGATIMTCVKEVPLRRHLLMASLLAVLAV	YCFT_ECOLI	B
C6EGX0_ECOBD	MKKFIILLSLLILLPLTAASKPLIPIMKTLFTDVTGTVPDAEEIAHKAELFRQQTGIAPFIVVLPDINNEASLRQNGKAMLAHASSSLSDVKGSVLLLFTTREPRLIMITNGQVESGLDDKHLGLLIENHTLAYLHAGLWYQGINNALAVLQAQILKQPTPPLTYYPHPGKQHENDPPGSTNTLGFIAWAATFVLFSSVFYYTTRFIYALKFAVAMTIANMGYQALCLYIDN	YCFZ_ECOLI	B
C6EGM7_ECOBD	MIQTFFDFPVYFKFFIGLFALVNPVGIIPVFISMTSYQTAAARNKTNLTANLSVAIILWISLFLGDTILQLFGISIDSFRIAGGILVVTIAMSMISGKLGEDKQNKQEKSETAVRESIGVVPLALPLMAGPGAISSTIVWGTRYHSISYLFGFFVAIALFALCCWGLFRMAPWLVRVLRQTGINVITRIMGLLLMALGIEFIVTGIKGIFPGLLN	YCHE_ECOLI	B
C6EGR1_ECOBD	MKRKNASLLGNVLMGLGLVVMVVGVGYSILNQLPQFNMPQYFAHGAVLSIFVGAILWLAGARVGGHEQVCDRYWWVRHYDKRCRRSDNRRHS	YCHH_ECOLI	B
C6EFS1_ECOBD	MNRLFSGRSDMPFALLLLAPSLLLLGGLVAWPMVSNIEISFLRLPLNPNIESTFVGVSNYVRILSDPDFWHSLWMTVWYTALVVAGSTVLGLAVAMFFNREFRLRKTARSLVILSYVTPSISLVFAWKYMFNNGYGIVNYLGVDLLHLYEQAPLWFDNPGSSFVLVVLFAIWRYFPYAFISFLAILQTIDKSLYEAAEMDGANAWQRFRIVTLPAIMPVLATVVTLRTIWMF	YCJO_ECOLI	B
C6EFS0_ECOBD	MATNKRTLSRIGFYCGLALFLIITLFPFFVMLMTSFKGAKEAISLHPTLLPQQWTLEHYVDIFNPMIFPFVDYFRNSLVVSVVSSVVAVFLGILGAYALSRLRFKGRMTINASFYTVYMFSGILLVVPLFKIITALGIYDTEMALIITMVTQTLPTAVFMLKSYFDTIPDEIEEAAMMDGLNRLQIIFRITVPLAMSGLISVFVYCFMVAWNDYLFASIFLSSASNFTLPVG	YCJP_ECOLI	B
C6EFR9_ECOBD	MKKLVATAPRVAALVEYEDRAILANEVKIRVRFGAPKHGTEVVDFRAASPFIDEDFNGEWQMFTPRPADAPRGIEFGKFQLGNMVVGDIIECGSDVTDYAVGDSVCGYGPLSETVIINAVNNYKLRKMPQGSSWKNAVCYDPAQFAMSGVRDANVRVGDFVVVVGLGAIGQIAIQLAKRAGASVVIGVDPIAHRCDIARRHGADFCLNPIGTDVGKEIKTLTGKQGADVIIE	YCJQ_ECOLI	B
C6EEQ5_ECOBD	MLQIIRGKLVIFLITLCLFVVYLGFDNNSNSDIVFYGHKTPKSVEIYLSEKNIIYKIINDQKISRGNGHFISIMVNNYRTHCGVVDINLNFFNDILYSVRLKNISKLENMEFCATKQRVYFSDKNKKASYKIINYGDYYDVDYYDNNLKNEVFDWIGKWS	YDCD_ECOLI	B
C6EET9_ECOBD	MANSITADEIREQFSQAMSAMYQQEVPQYGTLLELVADVNLAVLENNPQLHEKMVNADELARLNVERHGAIRVGTAQELATLRRMFAIMGMYPVSYYDLSQAGVPVHSTAFRPIDDASLARNPFRVFTSLLRLELIENEILRQKAAEILRQRDIFTPRCRQLLEEYEQQGGFNETQAQEFVQEALETFRWHQSATVDEETYRALHNEHRLIADVVCFPGCHINHLTPRTLDI	YDCJ_ECOLI	B
C6EET0_ECOBD	MRLFSIPPPTLLAGFLAVLIGYASSAAIIWQAAIVAGATTAQISGWMTALGLAMGVSTLTLTLWYRVPVLTAWSTPGAALLVTGLQGLTLNEAIGVFIVTNALIVLCGITGLFARLMRIIPHSLAAAMLAGILLRFGLQAFASLDGQFTLCGSMLLVWLATKAVAPRYAVIAAMIIGIVIVIAQGDVVTTDVVFKPVLPTYITPDFSFAHSLSVALPLFLVTMASQNAPGIA	YDCO_ECOLI	B
C6EES1_ECOBD	MAMNVLQSPSRPGLGKVSGFFWRNPGLGLFLLLLGPLMWFGIVYFGSLLTLLWQGFYTFDDFTMSVTPELTLANIRALFNPANYDIILRTLTMAVAVTIASAILAFPMAWYMARYTSGKMKAFFYIAVMLPMWASYIVKAYAWTLLLAKDGVAQWFLQHLGLEPLLTAFLTLPAVGGNTLSTSGLGRFLVFLYIWLPFMILPVQAALERLPPSLLQASADLGARPRQTFRYV	YDCU_ECOLI	B
C6EES0_ECOBD	MHSERAPFFLKLAAWGGVVFLHFPILIIAAYAFNTEDAAFSFPPQGLTLRWFSVAAQRSDILDAVTLSLKVAALATLIALVLGTLAAAALWRRDFFGKNAISLLLLLPIALPGIVTGLALLTAFKTINLEPGFFTIVVGHATFCVVVVFNNVIARFRRTSWSLVEASMDLGANGWQTFRYVVLPNLSSALLAGGMLAFALSFDEIIVTTFTAGHERTLPLWLLNQLGRPRDV	YDCV_ECOLI	B
C6EER8_ECOBD	MSLYQHMLVFYAVMAAIAFLITWFLSHDKKRIRFLSAFLVGATWPMSFPVALLFSLF	YDCX_ECOLI	B
C6EER6_ECOBD	MNQSLTLAFLIAAGIGLVVQNTLMVRITQTSSTILIAMLLNSLVGILLFVSILWFKQGMAGFGELVSSVRWWTLIPGLLGSFFVFASISGYQNVGAATTIAVLVASQLIGGLMLDIFRSHGVPLRALFGPICGAILLVVGAWLVARRSF	YDCZ_ECOLI	B
C6EEM1_ECOBD	MITIPITLRMLIAKYLCLLKPFWLRKNNKTSVLLIIIILAMILGVVKIQVWLNDWNNDFFNALSQKETDKLWQLVLWFPALLGIFVLISVNKTWLIKLLTIRWREWLTDYYLNRWFADKNYYFTQIYGEHKNTDNPDQRIAEDILLLISKTLSLSFGFIQSLSMLITFTVILWQSAGTLSFTVGGTEWNIQGYMVYTVVLIVIGGTLFTHKVGKRIRPLNVEKQRSEATFRT	YDDA_ECOLI	B
C6EEP4_ECOBD	MVGLIRGVSEGLGPVGGAAAIYSLSGLLLIFTVGFPRIRQIPKGYLLAGSLLFVSYEICLALSLGYAATRHQAIEVGMVNYLWPSLTILFAILFNGQKTNWLIVPGLLLALVGVCWVLGGDNGLHYDEIINNITTSPLSYFLAFIGAFIWAAYCTVTNKYARGFNGITVFVLLTGASLWVYYFLTPQPEMVFSTPVMIKLISAAFTLGFAYAAWNVGILHGNVTIMAVGSYF	YDDG_ECOLI	B
C6EDV3_ECOBD	MNLSLRRSTSALLASSLLLTIGRGATLPFMTIYLSRQYSLSVDLIGYAMTIALTIGVVFSLGFGILADKFDKKRYMLLAITAFASGFIAIPLVNNVTLVVLFFALINCAYSVFATVLKAWFADNLSSTSKTKIFSINYTMLNIGWTIGPPLGTLLVMQSINLPFWLAAICSAFPMLFIQIWVKRSEKIIATDTGSVWSPKVLLQDKALLWFTCSGFLASFVSGAFASCISQY	YDEE_ECOLI	B
C6EDU9_ECOBD	MNINRDKIVQLVDTDTIENLTSALSQRLIADQLRLTTAESCTGGKLASALCAAEDTPKFYGAGFVTFTDQAKMKILSVSQQSLERYSAVSEKVAAEMATGAIERADADVSIAITGYGGPEGGEDGTPAGTVWFAWHIKGQNYTAVMHFAGDCETVLALAVRFALAQLLQLLL	YDEJ_ECOLI	B
C6EEL8_ECOBD	MSLVCSVIFIHHAFNANILDKDYAFSDGEILMVDNAVRTHFEPYERHFKEIGFTENTIKKYLQCTNIQTVTVPVPAKFLRASNVPTGLLNEMIAYLNSEERNHHNFSELLLFSCLSIFAACKGFITLLTNGVLSVSGKVRNIVNMKLAHPWKLKDICDCLYISESLLKKKLKQEQTTFSQILLDARMQHAKNLIRVEGSVNKIAEQCGYASTSYFIYAFRKHFGNSPKRVSK	YDEO_ECOLI	B
C6EDP1_ECOBD	MGLVIKAALGALVVLLIGVLAKTKNYYIAGLIPLFPTFALIAHYIVASERGIEALRATIIFSMWSIIPYFVYLVSLWYFTGMMRLPAAFVGSVACWGISAWVLIICWIKLH	YDGC_ECOLI	B
C6EDM0_ECOBD	MTTTTPQRIGGWLLGPLAWLLVALLSTTLALLLYTAALSSPQTFQTLGGQALTTQILWGVSFITAIAMWYYTLWLTIAFFKRRRCVPKHYIIWLLISVLLAVKAFAFSPVEDGIAVRQLLFTLLATALIVPYFKRSSRVKATFVNP	YDGK_ECOLI	B
C6EDK2_ECOBD	MKFMLNATGLPLQDLVFGASVYFPPFFKAFAFGFVIWLVVHRLLRGWIYAGDIWHPLLMDLSLFAICVCLALAILIAW	YDHI_ECOLI	B
C6EDK0_ECOBD	MNASSWSLRNLPWFKATLAQWRYALRNTIAMCLALTVAYYLNLDEPYWAMTSAAVVSFPTVGGVISKSLGRIAGSLLGAIAALLLAGHTLNEPWFFLLSMSAWLGFCTWACAHFTNNVAYAFQLAGYTAAIIAFPMVNITEASQLWDIAQARVCEVIVGILCGGMMMMILPSSSDATALLTALKNMHARLLEHASLLWQPETTDAIRAAHEGVIGQILTMNLLRIQAFWSHY	YDHK_ECOLI	B
C6ECU6_ECOBD	MKINYPLLALAIGAFGIGTTEFSPMGLLPVIARGVDVSIPAAGMLISAYAVGVMVGAPLMTLLLSHRARRSALIFLMAIFTLGNVLSAIAPDYMTLMLSRILTSLNHGAFFGLGSVVAASVVPKHKQASAVATMFMGLTLANIGGVPAATWLGETIGWRMSFLATAGLGVISMVSLFFSLPKGGAGARPEVKKELAVLMRPQVLSALLTTVLGAGAMFTLYTYISPVLQSIT	YDHP_ECOLI	B
C6ECT1_ECOBD	MNPVDRPLLDIGLTRLEFLRISGKGLAGLTIAPALLSLLGCKQEDIDSGTVGLINTPKGVLVTQRARCTGCHRCEISCTNFNDGSVGTFFSRIKIHRNYFFGDNGVGSGGGLYGDLNYTADTCRQCKEPQCMNVCPIGAITWQQKEGCITVDHKRCIGCSACTTACPWMMATVNTESKKSSKCVLCGECANACPTGALKIIEWKDITV	YDHY_ECOLI	B
C6ECR6_ECOBD	MSQNKAFSTPFILAVLCIYFSYFLHGISVITLAQNMSSLAEKFSTDNAGIAYLISGIGLGRLISILFFGVISDKFGRRAVILMAVIMYLLFFFGIPACPNLTLAYGLAVCVGIANSALDTGGYPALMECFPKASGSAVILVKAMVSFGQMFYPMLVSYMLLNNIWYGYGLIIPGILFVLITLMLLKSKFPSQLVDASVTNELPQMNSKPLVWLEGVSSVLFGVAAFSTFYVI	YDIN_ECOLI	B
C6ECI8_ECOBD	MEQYDQIGARLDRLPLARFHYRIFGIISFSLLLTGFLSYSGNVVLAKLVSNGWSNNFLNAAFTSALMFGYFIGSLTGGFIGDYFGRRRAFRINLLIVGIAATGAAFVPDMYWLIFFRFLMGTGMGALIMVGYASFTEFIPATVRGKWSARLSFVGNWSPMLSAAIGVVVIAFFSWRIMFLLGGIGILLAWLLSGKYFIESPRWLAGKGQIAGAECQLREVEQQIEREKSIRL	YDJE_ECOLI	B
C6ECI3_ECOBD	MKNSKAILQVPGTMKIISAEIPVPKEDEVLIKVEYVGICGSDVHGFESGPFIPPKDPNQEIGLGHECAGTVVAVGSRVRKFKPGDRVNIEPGVPCGHCRYCLEGKYNICPDVDFMATQPNYRGALTHYLCHPESFTYKLPDNMDTMEGALVEPAAVGMHAAMLADVKPGKKIIILGAGCIGLMTLQACKCLGATEIAVVDVLEKRLAMAEQLGATVVINGAKEDTIARCQQF	YDJJ_ECOLI	B
C6ECI2_ECOBD	MEQITKPHCGARLDRLPDCRWHSSMFAIVAFGLLVCWSNAVGGLILAQLKALGWTDNSTTATFSAITTAGMFLGALVGGIIGDKTGRRNAFILYEAIHIASMVVGAFSPNMDFLIACRFVMGVGLGALLVTLFAGFTEYMPGRNRGTWSSRVSFIGNWSYPLCSLIAMGLTPLISAEWNWRVQLLIPAILSLIATALAWRYFPESPRWLESRGRYQEAEKVMRSIEEGVIHQ	YDJK_ECOLI	B
C6EC53_ECOBD	MKALARFGKAFGGYKMIDVPQPMCGPEDVVIEIKAAAICGADMKHYNVDSGSDEFNSIRGHEFAGCIAQVGEKVKDWKVGQRVVSDNSGHVCGVCPACEQGDFLCCTEKVNLGLDNNTWGGGFSKYCLVPGEILKIHRHALWEIPDGVDYEDAAVLDPICNAYKSIAQQSKFLPGQDVVVIGTGPLGLFSVQMARIMGAVNIVVVGLQEDVAVRFPVAKELGATAVVNGSTE	YDJL_ECOLI	B
C6ECK7_ECOBD	MNAERNFLFACLIFALVIYAIHAFGLFDLLTDLPHLQTLIRQSGLFGYSLYILLFIIATLFLLPGSILVIAGGIVFGPLLGTLLSLIAATLASSCSFLLARWLGRDLLLKYVGHSHTFQAIEKGIARNGIDFLILTRLIPLFPYNIQNYAYGLTTIAFWPYTLISALTTLPGIVIYTVMASDLANEGITLRFILQLCLAGLALFILVQLAKLYARHKHVDLSASRRSPLTHP	YDJX_ECOLI	B
C6ECK5_ECOBD	MMKIQSRKIWYYRITLIILLFAMLLAWALLPGVHEFINRSVAAFAAVDQQGIERFIQSYGALAAVVSFLLMILQAIAAPLPAFLITFANASLFGAFWGGLLSWTSSMAGAALCFFIARVMGREVVEKLTGKTVLDSMDGFFTRYGKHTILVCRLLPFVPFDPISYAAGLTSIRFRSFFIATGLGQLPATIVYSWAGSMLTGGTFWFVTGLFILFALTVVIFMAKKIWLERQK	YDJZ_ECOLI	B
C6EC45_ECOBD	MIQSTRISMGLFFKYFLSLTKIDLGQNYISLPSIKSSTHIALLFMVSMGTQKLKAQSFFIFSLLLTLILFCITTLYNENTNVKLIPQMNYLMVVVALFFLNAVIFLFMLMKYFTNKQILPTLILSLAFLSGLIYLVETIVIIHKPINGSTLIQTKSNDVSIFYIFRQLSFICLTSLALFCYGKDNILDNNKKKTGILLLALIPFLVFPLLAHNLSSYNADYSLYVVDYCPDN	YEAI_ECOLI	B
C6EC42_ECOBD	MFDVTLLILLGLAALGFISHNTTVAVSILVLIIVRVTPLSTFFPWIEKQGLSIGIIILTIGVMAPIASGTLPPSTLIHSFLNWKSLVAIAVGVIVSWLGGRGVTLMGSQPQLVAGLLVGTVLGVALFRGVPVGPLIAAGLVSLIVGKQ	YEAL_ECOLI	B
C6EC40_ECOBD	MTCSTSLSGKNRIVLIAGILMIATTLRVTFTGAAPLLDTIRSAYSLTTAQTGLLTTLPLLAFALISPLAAPVARRFGMERSLFAALLLICAGIAIRSLPSPYLLFGGTAVIGGGIALGNVLLPGLIKRDFPHSVARLTGAYSLTMGAAAALGSAMVVPLALNGFGWQGALLMLMCFPLLALFLWLPQWRSQQHANLSTSRALHTRGIWRSPLAWQVTLFLGINSLVYYVIIG	YEAN_ECOLI	B
C6EC09_ECOBD	MNITATVLLAFGMSMDAFAASIGKGATLHKPKFSEALRTGLIFGAVETLTPLIGWGMGMLASRFVLEWNHWIAFVLLIFLGGRMIIEGFRGADDEDEEPRRRHGFWLLVTTAIATSLDAMAVGVGLAFLQVNIIATALAIGCATLIMSTLGMMVGRFIGSIIGKKAEILGGLVLIGIGVQILWTHFHG	YEBN_ECOLI	B
C6EBZ6_ECOBD	MALNTPQITPTKKITVRSIGEELPRGDYQRCPQCDMLFSLPEINSHQSAYCPRCQAKIRDGRDWSLTRLAAMAFTMLLLMPFAWGEPLLHIWLLGIRIDANVMQGIWQMTKQGDTITGAMVFFCVIGAPLILVSSIAYLWFGNRLGMNLRPVLLMLERLKEWVMLDIYLVGIGVASIKVQDYAHIQAGVGLFSFVALVILTTVTLSHLNVEELWERFYPQRPATRRDEKLRV	YEBS_ECOLI	B
C6EBY9_ECOBD	MLAFTWIALRFIHFTSLMLVFGFAMYGAWLAPLTIRRLLAKRFLRLQQHAAVWSLISATAMLAVQGGLMGTGWTDVFSPNIWQAVLQTQFGGVWLWQIVLALVTLIVALMQPRNMPRLLFMLTTAQFFLLAGVGHATLNEGVTEKIHQTNHAIHLICAAAWFGGLLPVLWCMQLIKGRWRHQTIQALMRFSWCGHFAVIGVLASGVLNALLITGFPPTLTTYWGQLLLLKAI	YEBZ_ECOLI	B
C6EBE3_ECOBD	MQESIQLVIDSLPFLLKGAGYTLQLSIGGMFFGLLLGFILALMRLSPIWPVRWLARFYISIFRGTPLIAQLFMIYYGLPQFGIELDPIPSAMIGLSLNTAAYAAETLRAAISSIDKGQWEAAASIGMTPWQTMRRAILPQAARVALPPLSNSFISLVKDTSLAATIQVPELFRQAQLITSRTLEVFTMYLAASLIYWIMATVLSTLQNHFENQLNRQEREPK	YECS_ECOLI	B
C6EBA7_ECOBD	MRFRQLLPLFGALFALYIIWGSTYFVIRIGVESWPPLMMAGVRFLAAGILLLAFLLLRGHKLPPLRPLLNAALIGLLLLAVGNGMVTVAEHQNVPSGIAAVVVATVPLFTLCFSRLFGIKTRKLEWVGIAIGLAGIIMLNSGGNLSGNPWGAILILIGSISWAFGSVYGSRITLPVGMMAGAIEMLAAGVVLMIASMIAGEKLTALPSLSGFLAVGYLALFGSIIAINAYMY	YEDA_ECOLI	B
C6EBD2_ECOBD	MSWQQFKHAWLIKFWAPIPAVIAAGILSTYYFGITGTFWAVTGEFTRWGGQLLQLFGVHAEEWGYFKIIHLEGSPLTRIDGMMILGMFGGCFAAALWANNVKLRMPRSRIRIMQAIIGGIIAGFGARLAMGCNLAAFFTGIPQFSLHAWFFAIATAIGSWFGARFTLLPIFRIPVKMQKVSAASPLTQKPDQARRRFRLGMLVFFGMLGWALLTAMNQPKLGLAMLFGVGFG	YEDE_ECOLI	B
C6EBA8_ECOBD	MLLAGSSLLTLLDDIATLLDDISVMGKLAAKKTAGVLGDDLSLNAQQVSGVRANRELPVVWGVAKGSLINKVILVPLALIISAFIPWAITPLLMIGGAFLCFEGVEKVLHMLEARKHKEDPAQSQQRLEKLAAQDPLKFEKDKIKGAIRTDFILSAEIVAITLGIVAEAPLLNQVLVLSGIALVVTVGVYGLVGVIVKIDDLGYWLAEKSSALMQALGKGLLIIAPWLMKAL	YEDI_ECOLI	B
C6EBA4_ECOBD	MDLQHWQAQFENWLKNHHQHQDAAHDVCHFRRVWATAQKLAADDDVDMLVILTACYFHDIVSLAKNHPQRQRSSILAAEETRRLLREEFEQFPAEKIEAVCHAIAAHSFSAQIAPLTTEAKIVQDADRLEALGAIGLARVFAVSGALGVALFDGEDPFAQHRPLDDKRYALDHFQTKLLKLPQTMQTARGKQLAQHNAHFLVEFMAKLSAELAGENEGVDHKVIDAFSSAG	YEDJ_ECOLI	B
C6EBA3_ECOBD	MEYGSTKMEERLSRSPGGKLALWAFYTWCGYFVWAMARYIWVMSRIPDAPVSGFESDLGSTAGKWLGALVGFLFMALVGALLGSIAWYTRPRPARSRRYE	YEDR_ECOLI	B
C6EB96_ECOBD	MRLTAKQVTWLKVCLHLAGLLPFLWLVWAINHGGLGADPVKDIQHFTGRTALKFLLATLLITPLARYAKQPLLIRTRRLLGLWCFALMNPLMIFIKIIKLR	YEDZ_ECOLI	B
C6EB69_ECOBD	MSHNVTPNTSRVELRKTLTLVPVVMMGLAYMQPMTLFDTFGIVSGLTDGHVPTAYAFALIAILFTALSYGKLVRRYPSAGSAYTYAQKSISPTVGFMVGWSSLLDYLFAPMINILLAKIYFEALVPSIPSWMFVVALVAFMTAFNLRSLKSVANFNTVIVVLQVVLIAVILGMVVYGVFEGEGAGTLASTRPFWSGDAHVIPMITGATILCFSFTGFDGISNLSEETKDAER	YEEF_ECOLI	B
C6EB85_ECOBD	MWFHFLQLRSALNISSALRQVVHGTRWHAKRKSYKVLFWREITPLAVPIFMENACVLLMGVLSTFLVSWLGKDAMAGVGLADSFNMVIMAFFAAIDLGTTVVVAFSLGKRDRRRARVATRQSLVIMTLFAVLLATLIHHFGEQIIDFVAGDATTEVKALALTYLELTVLSYPAAAITLIGSGALRGAGNTKIPLLINGSLNILNIIISGILIYGLFSWPGLGFVGAGLGLTI	YEEO_ECOLI	B
C6EAN7_ECOBD	MKPTLYTATGECVTPGRELGKGGEGAVYDIEEFADSVAKIYHTPPPALKQDKLAFMAATADAQLLNYVAWPQATLHGGRGGKVIGFMMPKVSGKEPIHMIYSPAHRRQSYPHCAWDFLLYVARNIASSFATVHEHGHVVGDVNQNSFMVGRDSKVVLIDSDSFQINANGTLHLCEVGVSHFTPPELQTLPSFVGFERTANHDNFGLALLIFHVLFGGRHPYSGVPLISDAGN	YEGI_ECOLI	B
C6EAL2_ECOBD	MKTTAKLSFMMFVEWFIWGAWFVPLWLWLSKSGFSAGEIGWSYACTAIAAILSPILVGSITDRFFSAQKVLAVLMFAGALLMYFAAQQTTFAGFFPLLLAYSLTYMPTIALTNSIAFANVPDVERDFPRIRVMGTIGWIASGLACGFLPQMLGYADISPTNIPLLITAGSSALLGVFAFFLPDTPPKSTGKMDIKVMLGLDALILLRDKNFLVFFFCSFLFAMPLAFYYIFA	YEGT_ECOLI	B
C6EAK8_ECOBD	MQLRITSRKKLTALLCALGLISIVAIYPRQTVNFFYSTAVQITDYIHFYGYRPVKSFAIRIPASYTIHGIDVSRWQERIDWQRVAKMRDNGIRLQFAFIKATEGEKLEDPYFSRNWQLSRENGLLRGAYHYFSPSVAAPVQVRLFLQTVDFSQGDFPAVLDVEERGKLSAKELRKRVSQWLKMVEKSTGKKPIIYSGAVFYHTNLAGYFNEYPWWVAHYYQRRPDNDGMAWR	YEGX_ECOLI	B
C6EAI3_ECOBD	MKMLRDPLFWLIALFVALIFWLPYSQPLFAALFPQLPRPVYQQESFAALALAHFWLVGISSLFAVIIGTGAGIAVTRPWGAEFRPLVETIAAVGQTFPPVAVLAIAVPVIGFGLQPAIIALILYGVLPVLQATLAGLGAIDASVTEVAKGMGMSRGQRLRKVELPLAAPVILAGVRTSVIINIGTATIASTVGASTLGTPIIIGLSGFNTAYVIQGALLVALAAIIADRLFE	YEHW_ECOLI	B
C6EAI1_ECOBD	MTYFRINPVLALLLLLTAIAAALPFISYAPNRLVSGEGRHLWQLWPQTIWMLVGVGCAWLTACFIPGKKGSICALILAQFVFVLLVWGAGKAATQLAQNGSALARTSLGSGFWLAAALALLACSDAIRRISTHPLWRWLLHMQIAIIPLWLLYSGTLNDLSLMKEYANRQDVFDDALAQHLTLLFGAVLPALVIGVPLGIWCYFSTARQGAIFSLLNVIQTVPSVALFGLLI	YEHY_ECOLI	B
C6EAG1_ECOBD	MERNVTLDFVRGVAILGILLLNISAFGLPKAAYLNPAWYGAITPQDAWTWAFLDLIGQVKFLTLFALLFGAGLQMLLPRGRRWIQSRLTLLVLLGFIHGLLFWDGDILLAYGLVGLICWRLVRDAPSVKSLFNTGVMLYLVGLGVLLLLGLISDSQTSRAWTPDASAILYEKYWKLHGGVDAISNRADGVGNSLLALGAQYGWQLAGMMLIGAALMRSGWLKGQFSLRHYRR	YEIB_ECOLI	B
C6EAG7_ECOBD	MDVQQFFVVAVFFLIPIFCFREAWKGWRAGAIDKRVKNAPEPVYVWRAKNPGLFFAYMVAYIGFGILSIGMIVYLIFYR	YEIS_ECOLI	B
C6EA19_ECOBD	MGAYLIRRLLLVIPTLWAIITINFFIVQIAPGGPVDQAIAAIEFGNAGVLPGAGGEGVRASHAQTGVGNISDSNYRGGRGLDPEVIAEITHRYGFDKPIHERYFKMLWDYIRFDFGDSLFRSASVLTLIKDSLPVSITLGLWSTLIIYLVSIPLGIRKAVYNGSRFDVWSSAFIIIGYAIPAFLFAILLIVFFAGGSYFDLFPLRGLVSANFDSLPWYQKITDYLWHITLPV	YEJB_ECOLI	B
C6ELG1_ECOBD	MNGELIWVLSLLAVAIVLFATGRVRMDAVALFVIVAFALSGTLTVPEVFSGFSDPNVVLIAALFIIGDGLVRTGVATVMGTWLVKVAGNSEIKMLVLLMLTVAGLGAFMSSTGVVAIFIPVVLSVAMRMQTSPSRLMMPLSFAGLISGMMTLVATPPNLVVNSELLREGYHGFSFFSVTPIGLVVLVLGILYMLVMRFMLKGDTQTPQREGWTRRTFRDLIREYRLTGRARR	YFBS_ECOLI	B
C6ELF5_ECOBD	MQGNICAMSAITESKPTRRWAMPDTLVIIFFVAILTSLATWVVPVGMFDSQEVQYQVDGQTKTRKVVDPHSFRILTNEAGEPEYHRVQLFTTGDERPGLMNFPFEGLTSGSKYGTAVGIIMFMLVIGGAFGIVMRTGTIDNGILALIRHTRGNEILFIPALFILFSLGGAVFGMGEEAVAFAIIIAPLMVRLGYDSITTVLVTYIATQIGFASSWMNPFCVVVAQGIAGVPV	YFCC_ECOLI	B
C6EL97_ECOBD	MTNNESKGPFEGLLVIDMTHVLNGPFGTQLLCNMGARVIKVEPPGHGDDTRTFGPYVDGQSLYYSFINHGKESVVLDLKNDHDKSIFINMLKQADVLAENFRPGTMEKLGFSWETLQEINPRLIYASSSGFGHTGPLKDAPAYDTIIQAMSGIMMETGYPDAPPVRVGTSLADLCGGVYLFSGIVSALYGREKSQRGAHVDIAMFDATLSFLEHGLMAYIATGKSPQRLGNR	YFDE_ECOLI	B
C6EL96_ECOBD	MLTFFIGDLLPIIVIMLLGYFSGRRETFSEDQARAFNKLVLNYALPAALFVSITRANREMIFADTRLTLVSLVVIVGCFFFSWFGCYKFFKRTHAEAAVCALIAGSPTIGFLGFAVLDPIYGDSVSTGLVVAIISIIVNAITIPIGLYLLNPSSGADGKKNSNLSALISAAKEPVVWAPVLATILVLVGVKIPAAWDPTFNLIAKANSGVAVFAAGLTLAAHKFEFSAEIAY	YFDV_ECOLI	B
C6EL91_ECOBD	MIYLWMFLALCIVCVSGYIGQVLNVVSAVSSFFGMVILAALIYYFTMWLTGGNELVTGIFMFLAPACGLMIRFMVGYGRR	YFDY_ECOLI	B
C6EL79_ECOBD	MLHPRARTMLLLSLPAVAIGIASSLILIVVMKIASVLQNLLWQRLPGTLGIAQDSPLWIIGVLTLTGIAVGLVIRFSQGHAGPDPACEPLIGAPVPPSALPGLIVALILGLAGGVSLGPEHPIMTVNIALAVAIGARLLPRVNRMEWTILASAGTIGALFGTPVAAALIFSQTLNGSSEVPLWDRLFAPLMAAAAGALTTGLFFHPHFSLPIAHYGQMEMTDILSGAIVAAI	YFEO_ECOLI	B
C6EKK8_ECOBD	MKLNATYIKIRDKWWGLPLFLPSLILPIFAHINTFAHISSGEVFLFYLPLALMISMMMFFSWAALPGIALGIFVRKYAELGFYETLSLTANFIIIIILCWGGYRVFTPRRNNVSHGDTRLISQRIFWQIVFPATLFLILFQFAAFVGLLASRENLVGVMPFNLGTLINYQALLVGNLIGVPLCYFIIRVVRNPFYLRSYYSQLKQQVDAKVTKKEFALWLLALGALLLLLCM	YFGF_ECOLI	B
C6EKH3_ECOBD	MALPVNKRVPKILFILFVVAFCVYLVPRVAINFFYYPDDKIYGPDPWSAESVEFTAKDGTRLQGWFIPSSTGPADNAIATIIHAHGNAGNMSAHWPLVSWLPERNFNVFMFDYRGFGKSKGTPSQAGLLDDTQSAINVVRHRSDVNPQRLVLFGQSIGGANILAVIGQGDREGIRAVILDSTFASYATIANQMIPGSGYLLDESYSGENYIASVSPIPLLLIHGKADHVIPW	YFHR_ECOLI	B
C6EK09_ECOBD	MDLRRFITLKTVVEEGSFLRASQKLCCTQSTVTFHIQQLEQEFSVQLFEKIGRRMCLTREGKKLLPHIYELTRVMDTLREAAKKESDPDGELRVVSGETLLSYRMPQVLQRFRQRAPKVRLSLQSLNCYVIRDALLNDEADVGVFYRVGNDDALNRRELGEQSLVLVASPQIADVDFTEPGRHNACSFIINEPQCVFRQIFESTLRQRRITVENTIELISIESIKRCVAANI	YFIE_ECOLI	B
C6EJY8_ECOBD	MDNDNSLNKRPTFKRALRNISITSIFITMMLIWLLLSVTSVLTLKQYAQKNLALTAATMTYSLEAAVVFADGPAATETLAALGQQGQFSTAEVRDKQQNILASWHYTRKDPGDTFSNFISHWLFPAPIIQPIRHNGETIGEVRLTARDSSISHFIWFSLAVLTGCILLASGIAITLTRHLHNGLVEALKNITDVVHDVRSNRNFSRRVSEERIAEFHRFALDFNSLLDEMEE	YFIN_ECOLI	B
C6EJU3_ECOBD	MSYEVLLLGLLVGVANYCFRYLPLRLRVGNARPTKRGAVGILLDTIGIASICALLVVSTAPEVMHDTRRFVPTLVGFAVLGASFYKTRSIIIPTLLSALAYGLAWKVMAII	YGAH_ECOLI	B
C6EJV5_ECOBD	MFSPQSRLRHAVADTFAMVVYCSVVNMCIEVFLSGMSFEQSFYSRLVAIPVNILIAWPYGMYRDLFMRAARKVSPSGWIKNLADILAYVTFQSPVYVAILLVVGADWHQIMAAVSSNIVVSMLMGAVYGYFLDYCRRLFKVSRYQQVKA	YGAW_ECOLI	B
C6EJB8_ECOBD	MRNSHNITLTNNDSLTEDEETTWSLPGAVVGFISWLFALAMPMLIYGSNTLFFFIYTWPFFLALMPVAVVVGIALHSLMDGKLRYSIVFTLVTVGIMFGALFMWLLG	YGBE_ECOLI	B
C6EJD1_ECOBD	MKTGSEFHVGIVGLGSMGMGAALSCVRAGLSTWGADLNSNACATLKEAGACGVSDNAATFAEKLDALLVLVVNAAQVKQVLFGETGVAQHLKPGTAVMVSSTIASADAQEIAIALAGFDLEMLDAPVSGGAVKAANGEMTIMASGSDIAFERLAPVLEAVAGKVYRIGAEPGLGSTVKIIHQLLAGVHIAAGAEAMALAARAGIPLDVMYDVVTNAAGNSWMFENRMRHVVD	YGBJ_ECOLI	B
C6EJC7_ECOBD	MSTITLLCIALTGVIMLLLLVIKAKVQPFVALLLVSLLVALAAGIPAGEVGKVMIAGMGGVLGSVTIIIGLGAMLGRMIEHSGGAESLANYFSRKLGDKRTIAALTLAAFFLGIPVFFDVGFIILAPIIYGFAKVAKISPLKFGLPVAGIMLTVHVAVPPHPGPVAAAGLLHADIGWLTIIGIAISIPVGVVGYFAAKIINKRQYAMSVEVLEQMQLAPASEEGATKLSDKI	YGBN_ECOLI	B
C6EJ94_ECOBD	MRYFILMFTFVCSFVAAQPTIVPQLQQQVTDLTSSLNSQEKKELTHKLESIFNNTQVQIAVLIVPTTKDETIEQYATRVFDNWRLGDAKRNDGILIVVAWSDRTVRIQVGYGLEEKVTDALAGDIIRSNMIPAFKQQKLAKGLELAINALNNQLTSQHQYPTNPSESESASSSDHYYFAIFWVFAVMFFPFWFFHQGSNFCRACKSGVCISAIYLLDLFLFSDKIFSIAVFS	YGCG_ECOLI	B
C6EJA1_ECOBD	MTGRCLFGFSGEKPFLLPDNEGVKMNTSPVRMDDLPLNRFHCRIAALTFGAHLTDGYVLGVIGYAIIQLTPAMQLTPFMAGMIGGSALLGLFLGSLVLGWISDHIGRQKIFTFSFLLITLASFLQFFATTPEHLIGLRILIGIGLGGDYSVGHTLLAEFSPRRHRGILLGAFSVVWTVGYVLASIAGHHFISENPEAWRWLLASAALPALLITLLRWGTPESPRWLLRQGRF	YGCS_ECOLI	B
C6EJ59_ECOBD	MTSRFMLIFAAISGFIFVALGAFGAHVLSKTMGAVEMGWIQTGLEYQAFHTLAILGLAVAMQRRISIWFYWSSVFLALGTVLFSGSLYCLALSHLRLWAFVTPVGGVSFLAGWALMLVGAIRLKRKGVSHE	YGDD_ECOLI	B
C6EJ36_ECOBD	MLFAWITDPNAWLALGTLTLLEIVLGIDNIIFLSLVVAKLPTAQRAHARRLGLAGAMVMRLALLASIAWVTRLTNPLFTIFSQEISARDLILLLGGLFLIWKASKEIHESIEGEEEGLKTRVSSFLGAIVQIMLLDIIFSLDSVITAVGLSDHLFIMMAAVVIAVGVMMFAARSIGDFVERHPSVKMLALSFLILVGFTLILESFDIHVPKGYIYFAMFFSIAVESLNLIRN	YGDQ_ECOLI	B
C6EIM1_ECOBD	MSAIDSQLPSSSGQDRPTDEVDRILSPGKLIILGLQHVLVMYAGAVAVPLMIGDRLGLSKEAIAMLISSDLFCCGIVTLLQCIGIGRFMGIRLPVIMSVTFAAVTPMIAIGMNPDIGLLGIFGATIAAGFITTLLAPLIGRLMPLFPPLVTGVVITSIGLSIIQVGIDWAAGGKGNPQYGNPVYLGISFAVLIFILLITRYAKGFMSNVAVLLGIVFGFLLSWMMNEVNLSG	YGFU_ECOLI	B
C6EI09_ECOBD	MAGFNIKHWFADGAFRTIIRNSAWLGSSNVVSALLGLLALSCAGKGMTPAMFGVLVIVQSYAKSISDFIKFQTWQLVVQYGTPALTNNNPQQFRNVVSFSFSLDIVSGAVAIVGGIALLPFLSHSLGLDDQSFWLAALYCTLIPSMASSTPTGILRAVDRFDLIAVQQATKPFLRAAGSVVAWYFDFGFAGFVIAWYVSNLVGGTMYWWFAARELRRRNIHNAFKLNLFESA	YGHQ_ECOLI	B
C6EI08_ECOBD	MDALQTQTVNSTTAPQPNYIPGLIAVVGCDGTGKSTLTTDLVKSLQQHWQTERRYLGLLSGEDGDKIKRLPLVGVWLERRLAAKSSKTQSMKTKSPALWAAVIMYCFSLRRMANLRKVQRLAQSGVLVVSDRFPQAEISGFYYDGPGIGVERATGKISMFLAQRERRLYQQMAQYRPELIIRLGIDIETAISRKPDHDYAELQDKIGVMSKIGYNGTKILEIDSRAPYSEVL	YGHR_ECOLI	B
C6EI07_ECOBD	MSIINSTPVRVIAIVGCDGSGKSTLTASLVNELAARMPTEHIYLGQSSGRIGEWISQLPVIGAPFGRYLRSKAAHVHEKPSTPPGNITALVIYLLSCWRAYKFRKMLCKSQQGFLLITDRYPQVEVPGFRFDGPQLAKTTGGNGWIKMLRQRELKLYQWMASYLPVLLIRLGIDEQTAFARKPDHQLAALQEKIAVTPQLTFNGAKILELDGRHPADEILQASLRAIHAALS	YGHS_ECOLI	B
C6EI06_ECOBD	MQSITPPLIAVIGSDGSGKSTVCEHLITVVEKYGAAERVHLGKQAGNVGRAVTKLPLMGKSLHKTIERNQVKTAKKLPGPVPALVITAFVARRLLRFRHMLACRRRGLIVLTDRYPQDQIPGAYDGTVFPPNVEGGRFVSWLASQERKAFHWMASHKPDLVIKLNVDLEVACARKPDHKRESLARKIAITPQLTFGGAQLVDIDANQPLEQVLVDAEKAITDFMTARGYH	YGHT_ECOLI	B
C6EHW6_ECOBD	MLKQKIKTIFEALLYIMLTYWLIDSFFAFNKYDWMLESGGNICSIPSVSGEDRILQAMIAAFFLLTPLIILILRKLFMREMFEFWVYVFSLGICLVCGWWLFWGRFIFCY	YGIZ_ECOLI	B
C6EHR8_ECOBD	MSDTKRNTIGKFGLLSLTFAAVYSFNNVINNNIELGLASAPMFFLATIFYFIPFCLIIAEFVSLNKNSEAGVYAWVKSSLGGRWAFITAYTYWFVNLFFFTSLLPRVIAYASYAFLGYEYIMTPVATTIISMVLFAFSTWVSTNGAKMLGPITSVTSTLMLLLTLSYILLAGTALVGGVQPADAITVDAMIPNFNWAFLGVTTWIFMAAGGAESVAVYVNDVKGGSKSFVKV	YGJI_ECOLI	B
C6EHR0_ECOBD	MLRAFARLLLRICFSRRTLKIACLLLLVAGATILIADRVMVNASKQLTWSDVNAVPARNVGLLLGARPGNRYFTRRIDTAAALYHAGKVKWLLVSGDNGRKNYDEASGMQQALIAKGVPAKVIFCDYAGFSTLDSVVRAKKVFGENHITIISQEFHNQRAIWLAKQYGIDAIGFNAPDLNMKHGFYTQLREKLARVSAVIDAKILHRQPKYLGPSVMIGPFSEHGCPAQK	YGJQ_ECOLI	B
C6EHQ4_ECOBD	MTAYWLAQGVGVIAFLIGITTFFNRDERRFKKQLSVYSAVIGVHFFLLGTYPAGASAILNAIRTLITLRTRSLWVMAIFIVLTGGIGLAKFHHPVELLPVIGTIVSTWALFRCKGLTMRCVMWFSTCCWVIHNFWAGSIGGTMIEGSFLLMNGLNIIRFWRMQKRGIDPFKVEKTPPAIDERG	YGJV_ECOLI	B
C6EHN8_ECOBD	MQWYLSVLKNYVGFSGRARRKEYWMFTLINAIVGAIINVIQLILGLELPYLSMLYLLATFLPVLALAIRRLHDTDRSGAWALLFFVPFIGWLVLLVFFCTEGTSGSNRYGNDPKFGSN	YHAI_ECOLI	B
C6EH53_ECOBD	MTVFNKFARSFKSHWLLYLCVIVFGITNLVASSGAHMVQRLLFFVLTILVVKRISSLPLRLLVAAPFVLLTAADMSISLYSWCTFGTTFNDGFAISVLQSDPDEVVKMLGMYIPYLCAFAFLSLLFLAVIIKYDVSLPTKKVTGILLLIVISGSLFSACQFAYKDAKNKKAFSPYILASRFATYTPFFNLNYFALAAKEHQRLLSIANTVPYFQLSVRDTGIDTYVLIVGES	YHBX_ECOLI	B
C6EGJ7_ECOBD	MIRKYWWLVVFAVFVFLFDTLLMQWIELLATETDKCRNMNSVNPLKLVNCDELNFQDRM	YHDU_ECOLI	B
C6EGJ0_ECOBD	MSHRRSTVKGSLSFANPTVRAWLFQILAVVAVVGIVGWLFHNTVTNLNNRGITSGFAFLDRSAGFGIVQHLIDYQQGDTYGRVFIVGLLNTLLVSALCIVFASVLGFFIGLARLSDNWLLRKLSTIYIEIFRNIPPLLQIFFWYFAVLRNLPGPRQAVSAFDLAFLSNRGLYIPSPQLGDGFIAFILAVVMAIVLSVGLFRFNKTYQIKTGQLRRTWPIAAVLIIGLPLLAQ	YHDX_ECOLI	B
C6EGI9_ECOBD	MTKVLLSHPPRPASHNSNRAMVWVRKNLFSSWSNSLLTIGCIWLMWELIPPLLNWAFLQANWVGSTRADCTKAGACWVFIHERFGQFMYGLYPHDQRWRINLALLIGLVSIAPMFWKILPHRGRYIAAWAVIYPLIVWWLMYGGFFALERVETRQWGGLTLTLIIASVGIAGALPWGILLALGRRSHMPIVRILSVIFIEFWRGVPLITVLFMSSVMLPLFMAEGTSIDKLI	YHDY_ECOLI	B
C6EFJ9_ECOBD	MDLYIQIIVVACLTGMTSLLAHRSAAVFHDGIRPILPQLIEGYMNRREAGSIAFGLSIGFVASVGISFTLKTGLLNAWLLFLPTDILGVLAINSLMAFGLGAIWGVLILTCLLPVNQLLTALPVDVLGSLGALSSPVVSAFALFPLVAIFYQFGWKQSLIAAVVVLMTRVVVVRYFPHLNPESIEIFIGMVMLLGIAITHDLRHRDENDIDASGLSVFEERTSRIIKNLPYI	YHFT_ECOLI	B
C6EFH3_ECOBD	MDNVELSPATRWGMIATGLLQGLVCYLLIAWLSGKNHSWIVYGVPATVAFSSVLLFSVISFKQKRLWGWLALVFIATLGMSGWLKWQTDGMNPWRAEKALWDFGCYLLLMAMLLLPWIQQSLRIRNDSSRYRYFYQSVWHNVLILLVIFLANGLTWLVLLLWSELFKLVGITFFNTLFFATDWFIYLTLGLVTALAVILARTQSRLIDSIQKLFTLIATGLLPLVSLLTLMF	YHGE_ECOLI	B
C6EFE0_ECOBD	MNEIISAAVLLILIMDPLGNLPIFMSVLKHTEPKRRRAIMVRELLIALLVMLVFLFAGEKILAFLSLRAETVSISGGIILFLIAIKMIFPSASGNSSGLPAGEEPFIVPLAIPLVAGPTILATLMLLSHQYPNQMGHLVIALLLAWGGTFVILLQSSLFLRLLGEKGVNALERLMGLILVMMATQMFLDGIRMWMKG	YHGN_ECOLI	B
C6EF91_ECOBD	MSAEFMVICKKILFRNCVIVSLFVFTYNTWAQCNNNIKIMRKYESEGKYTVRNLVKNKAIALGLAEIYVKNRYGQDAAEEEKPYEITELTTSWVVEGTIHSDQIAGGVFIIEIGKNDGRILNFGHGK	YHHH_ECOLI	B
C6EFA8_ECOBD	MLINIGRLLMLCVWGFLILNLVHPFPRPLNIFVNVALIFTVLMHGMQLALLKSTLPKDGPQMTTAEKVRIFLFGVFELLAWQKKFKVKK	YHHL_ECOLI	B
C6EFA6_ECOBD	MLWSFIAVCLSAWLSVDASYRGPTWQRWVFKPLTLLLLLLLAWQAPMFDAISYLVLAGLCASLLGDALTLLPRQRLMYAIGAFFLSHLLYTIYFASQMTLSFFWPLPLVLLVLGALLLAIIWTRLEEYRWPICTFIGMTLVMVWLAGELWFFRPTAPALSAFVGASLLFISNFVWLGSHYRRRFRADNAIAAACYFAGHFLIVRSLYL	YHHN_ECOLI	B
C6EFA3_ECOBD	MNVFSQTQRYKALFWLSLFHLLVITSSNYLVQLPVSILGFHTTWGAFSFPFIFLATDLTVRIFGAPLARRIIFAVMIPALLISYVISSLFYMGSWQGFGALAHFNLFVARIATASFMAYALGQILDVHVFNRLRQSRRWWLAPTASTLFGNVSDTLAFFFIAFWRSPDAFMAEHWMEIALVDYCFKVLISIVFFLPMYGVLLNMLLKRLADKSEINALQAS	YHHQ_ECOLI	B
C6EFA1_ECOBD	MKHCCKNVVILMPEPVAEPALNGLRLNLRIVSIVMFNFASYLTIGLPLAVLPGYVHDVMGFSAFWAGLVISLQYFATLLSRPHAGRYADSLGPKKIVVFGLCGCFLSGLGYLTAGLTASLPVISLLLLCLGRVILGIGQSFAGTGSTLWGVGVVGSLHIGRVISWNGIVTYGAMAMGAPLGVVFYHWGGLQALALIIMGVALVAILLAIPRPTVKASKGKPLPFRAVLGRVW	YHHS_ECOLI	B
C6EFA0_ECOBD	METPQPDKTGMHILLKLASLVVILAGIHAAADIIVQLLLALFFAIVLNPLVTWFIRRGVQRPVAITIVVVVMLIALTALVGVLAASFNEFISMLPKFNKELTRKLFKLQEMLPFLNLHMSPERMLQRMDSEKVVTFTTALMTGLSGAMASVLLLVMTVVFMLFEVRHVPYKMRFALNNPQIHIAGLHRALKGVSHYLALKTLLSLWTGVIVWLGLELMGVQFALMWAVLAFL	YHHT_ECOLI	B
C6EEH7_ECOBD	MTAEFIIRLILAAIACGAIGMERQMRGKGAGLRTHVLIGMGSALFMIVSKYGFADVLSLDHVGLDPSRIAAQVVTGVGFIGAGNILVRNQNIVGLTTAADIWVTAAIGMVIGSGMYELGIYGSVMTLLVLEVFHQLTFRLMNKNYHLQLTLVNGNTVSMLDWFKQQKIKTDLVSLQENEDHEVVAIDIQLHATTSIEDLLRLLKGMAGVKGVSIS	YHID_ECOLI	B
C6EEJ4_ECOBD	MNIYIGWLFKLIPLIMGLICIALGGFVLESSGQSEYFVAGHVLISLAAICLALFTTAFIIISQLTRGVNTFYNTLFPIIGYAGSIITMIWGWALLAGNDVMADEFVAGHVIFGVGMIAACVSTVAASSGHFLLIPKNAAGSKSDGTPVQAYSSLIGNCLIAVPVLLTLLGFIWSITLLRSADITPHYVAGHVLLGLTAICACLIGLVATIVHQTRNTFSTKEHWLWCYWVIF	YHIM_ECOLI	B
C6EEJ3_ECOBD	MERFDAIIIGAGAAGMFCSALAGQAGRRVLLIDNGKKPGRKILMSGGGRCNFTNLYVEPGAYLSQNPHFCKSALARFTQWDFIDLVNKHGIAWHEKTLGQLFCDDSAQQIVNMLVDECEKGNVTFRLRSEVLSVAKDETGFTLDLNGMTVGCEKLVIATGGLSMPGLGASPFGYKIAEQFGLNVLPTRAGLVPFTLHKPLLEELQVLAGVAVPSVITAENGTVFRENLLFTH	YHIN_ECOLI	B
C6EEG0_ECOBD	MQATATTLDHEQEYTPINSRNKVLVASLIGTAIEFFDFYIYATAAVIVFPHIFFPQGDPTAATLQSLATFAIAFVARPIGSAVFGHFGDRVGRKATLVASLLTMGISTVVIGLLPGYATIGIFAPLLLALARFGQGLGLGGEWGGAALLATENAPPRKRALYGSFPQLGAPIGFFFANGTFLLLSWLLTDEQFMSWGWRVPFIFSAVLVIIGLYVRVSLHESPVFEKVAKAK	YHJE_ECOLI	B
C6EEE7_ECOBD	MDPVFSIGISSLWDELRHMPAGGVWWFNVDRHEDAISLANQTIASQAETAHVAVISMDSDPAKIFQLDDSQGPEKIKLFSMLNHEKGLYYLTRDLQCSIDPHNYLFILVCANNAWQNIPAERLRSWLDKMNKWSRLNHCSLLVINPGNNNDKQFSLLLEEYRSLFGLASLRFQGDQHLLDIAFWCNEKGVSARQQLSVQQQNGIWTLVQSEEAEIQPRSDEKRILSNVAVLE	YHJS_ECOLI	B
C6EEE6_ECOBD	MMTISDIIEIIVVCALIFFPLGYLARHSLRRIRDTLRLFFAKPRYVKPAGTLRRTEKARATKK	YHJT_ECOLI	B
C6EEE1_ECOBD	MQHNTLSKHNQKLPFTRYDFGWVLLCIGMAIGAGTVLMPVQIGLKGIWVFITAAIIAYPATWVVQDIYLKTLSESDSCNDYTDIISHYLGKNWGIFLGVIYFLMIIHGIFIYSLSVVFDSASYLKTFGLTDADLSQSLLYKVAIFAVLVAIASGGERLLFKISGPMVVVKVGIIVVFGFAMIPHWNFANITAFPQASVFFRDVLLTIPFCFFSAVFIQVLNPMNIAYRKREA	YHJV_ECOLI	B
C6EED4_ECOBD	MTPSNYQRTRWLTLIGTIITQFALGSVYTWSLFNGALSAKLDAPVSQVAFSFGLLSLGLAISSSVAGKLQERFGVKRVTIASGILLGLGFFLTAHSDNLMMLWLSAGVLVGLADGAGYLLTLSNCVKWFPERKGLISAFAIGSYGLGSLGFKFIDTQLLETVGLEKTFVIWGAIALVMIVFGATLMKDAPKQEVKTSNGVVEKDYTLAESMRKPQYWMLAVMFLTACMSGLY	YHJX_ECOLI	B
C6EEB6_ECOBD	MDNKISTYSPAFSIVSWIALVGGIVTYLLGLWNAEMQLNEKGYYFAVLVLGLFSAASYQKTVRDKYEGIPTTSIYYMTCLTVFIISVALLMVGLWNATLLLSEKGFYGLAFFLSLFGAVAVQKNIRDAGINPPKETQVTQEEYSE	YIAA_ECOLI	B
C6EEB5_ECOBD	MKTSKTVAKLLFVVGALVYLVGLWISCPLLSGKGYFLGVLMTATFGNYAYLRAEKLGQLDDFFTHICQLVALITIGLLFIGVLNAPINTYEMVIYPIAFFVCLFGQMRLFRSA	YIAB_ECOLI	B
C6EEB7_ECOBD	MQPKIYWIDNLRGIACLMVVMIHTTTWYVTNAHSVSPVTWDIANVLNSASRVSVPLFFMISGYLFFGERSAQPRHFLRIGLCLFFYSAIALLYIALFTSINVELALKNLLQKPVFYHLWFFFAIAVIYLVSPLIQVKNVGGKMLLVLMVVIGIIANPNTVPQKIDGFEWLPINLYINGDTFYYILYGMLGRAIGMMDTQHKALSWVSAVLFVTGVFIISRGTLYELQWRGNF	YIAH_ECOLI	B
C6EEA2_ECOBD	MKKILEAILAINLAVLSCIVFINIILRYGFQTSILSVDELSRYLFVWLTFIGAIVAFMDNAHVQVTFLVEKLSPAWQRRVALVTHSLILFICGALAWGATLKTIQDWSDYSPILGLPIGLMYAACLPTSLVIAFFELRHLYQLITRSNSLTSPPQGA	YIAM_ECOLI	B
C6EEA1_ECOBD	MAVLIFLGCLLGGIAIGLPIAWALLLCGAALMFWLDMFDVQIMAQTLVNGADSFSLLAIPFFVLAGEIMNAGGLSKRIVDLPMKLVGHKPGGLGYVGVLAAMIMASLSGSAVADTAAVAALLVPMMRSANYPVNRAAGLIASGGIIAPIIPPSIPFIIFGVSSGLSISKLFMAGIAPGMMMGATLMLTWWWQASRLNLPRQQKATMQEIWHSFVSGIWALFLPVIIIGGFRS	YIAN_ECOLI	B
C6EE91_ECOBD	MTKLQLKYRELKIISVIAASENISHAATVLGIAQANVSKYLADFESKVGLKVFDRTTRQLMLTPFGTALLPYINDMLDRNEQLNNFIADYKHEKRGRVTIYAPTGIITYLSKHVIDKIKDIGDITLSLKTCNLERNAFYEGVEFPDDCDVLISYAPPKDESLVASFITQYAVTAYASQRYLEKHPISRPDELEHHSCILIDSMMIDDANIWRFNVAGSKEVRDYRVKGNYVC	YIAU_ECOLI	B
C6EE90_ECOBD	MDLLIILTYVAFAWAMFKIFKIPVNKWTIPTATLGGIFIVSGLILLMNYNHPYTFKAQKAVISIPVVPQVTGVVIEVTDKKNTLIKKGEVLFRLDPTRYQARVDRLMADIVTAEHKQRALGAELDEMAANTQQAKATRDKFAKEYQRYARGSQAKVNPFSERDIDVARQNYLAQEASVKSSAAEQKQIQSQLDSLVLGEHSQIASLKAQLAEAKYNLEQTIVRAPSDGYVTQ	YIAV_ECOLI	B
C6EE89_ECOBD	MFLDYFALGVLIFVFLVIFYGIIILHDIPYLIAKKRNHPHADAIHVAGWVSLFTLHVIWPFLWIWATLYRPERGWGMQSHDSSVMQLQQRIAGLEKQLADIKSSSAE	YIAW_ECOLI	B
C6EE83_ECOBD	MKLVGSYTSPFVRKLSILLLEKGITFEFINELPYNADNGVAQFNPLGKVPVLVTEEGECWFDSPIIAEYIELMNVAPAMLPRDPLESLRVRKIEALADGIMDAGLVSVREQARPAAQQSEDELLRQREKINRSLDVLEGYLVDGTLKTDTVNLATIAIACAVGYLNFRRVAPGWCVDRPHLVKLVENLFSRESFARTEPPKA	YIBF_ECOLI	B
C6EDJ5_ECOBD	MDLLIVLTYVALAWAVFKIFRIPVNQWTLATAALGGVFLVSGLILLMNYNHPYTFTAQKAVIAIPITPQVTGIVTEVTDKNNQLIQKGEVLFKLDPVRYQARVDRLQADLMTATHNIKTLRAQLTEAQANTTQVSAERDRLFKNYQRYLKGSQAAVNPFSERDIDDARQNFLAQDALVKGSVAEQAQIQSQLDSMVNGEQSQIVSLRAQLTEAKYNLEQTVIRAPSNGYVTQ	YIBH_ECOLI	B
C6EDJ4_ECOBD	MFLNYFALGVLIFVFLVIFYGIIAIHDIPYLIAKKRNHPHADAIHTAGWVSLFTLHVIWPFLWIWATLYQPERGWGMQSHVASQEKATDPEIAALSDRISRLEHQLAAEKKTDYSTFPEI	YIBI_ECOLI	B
C6EDE4_ECOBD	MLLHILYLVGITAEAMTGALAAGRRRMDTFGVIIIATATAIGGGSVRDILLGHYPLGWVKHPEYVIIVATAAVLTTIVAPVMPYLRKVFLVLDALGLVVFSIIGAQVALDMGHGPIIAVVAAVTTGVFGGVLRDMFCKRIPLVFQKELYAGVSFASAVLYIALQHYVSNHDVVIISTLVFGFFARLLALRLKLGLPVFYYSHEGH	YICG_ECOLI	B
C6EDD2_ECOBD	MKSEVLSVKEKIGYGMGDAASHIIFDNVMLYMMFFYTDIFGIPAGFVGTMFLVARALDAISDPCMGLLADRTRSRRGKFRPWVLFGALPFGIVCVLAYSTPDLSMNGKMIYAAITYTLLTLLYTVVNIPYCALGGVITNDPTQRISLQSWRFVLATAGGMLSTVLMMPLVNLIGGDNKPLGFQGGIAVLSVVAFMMLAFCFFTTKERVEAPPTTTSMREDLRDIWQNDQWRI	YICJ_ECOLI	B
C6EDA5_ECOBD	MNNDNTDYVSNESGTLSRLFKLPQHGTTVRTELIAGMTTFLTMVYIVFVNPQILGAAQMDPKVVFVTTCLIAGIGSISMGIFANLPVALAPAMGLNAFFAFVVVGAMGISWQTGMGAIFWGAVGLFLLTLFRIRYWMISNIPLSLRIGITSGIGLFIALMGLKNTGVIVANKDTLVMIGDLSSHGVLLGILGFFIITVLSSRHFHAAVLVSIVVTSCCGLFFGDVHFSGVYS	YICO_ECOLI	B
C6ED85_ECOBD	MSDIALTVSILALVAVVGLFIGNVKFRGIGLGIGGVLFGGIIVGHFVSQAGMTLSSDMLHVIQEFGLILFVYTIGIQVGPGFFASLRVSGLRLNLFAVLIVIIGGLVTAILHKLFDIPLPVVLGIFSGAVTNTPALGAGQQILRDLGTPMEMVDQMGMSYAMAYPFGICGILFTMWMLRVIFRVNVETEAQQHESSRTNGGALIRTINIRVENPNLHDLAIKDVPILNGDKI	YIDE_ECOLI	B
C6ED93_ECOBD	MPDSRKARRIADPGLQPERTSLAWFRTMLGYGALMALAIKHNWHQAGMLFWISIGILAIVALILWHYTRNRNLMDVTNSDFSQFHVVRDKFLISLAVLSLAILFAVTHIHQLIVFIERVA	YIDG_ECOLI	B
C6ED92_ECOBD	MNISRLGEAPDYRFSLANERTFLAWIRTALGFLAAGVGLDQLAPDFATPVIRELLALLLCLFSGGLAMYGYLRWLRNEKAMRLKEDLPYTNSLLIISLILMVVAVIVMGLVLYAG	YIDH_ECOLI	B
C6ED91_ECOBD	MGIIAQNKISSLGMLFGAIALMMGIIHFSFGPFSAPPPTFESIVADKTAEIKRGLLAGIKGEKITTVEKKEDVDVDKILNQSGIALAIAALLCAFIGGMRKENRWGIRGALVFGGGTLAFHTLLFGIGIVCSILLIFLIFSFLTGGSLV	YIDI_ECOLI	B
C6ED89_ECOBD	MNSLQILSFVGFTLLVAVITWWKVRKTDTGSQQGYFLAGRSLKAPVIAASLMLTNLSTEQLVGLSGQAYKSGMSVMGWEVTSAVTLIFLALIFLPRYLKRGIATIPDFLEERYDKTTRIIIDFCFLIATGVCFLPIVLYSGALALNSLFHVGESLQISHGAAIWLLVILLGLAGILYAVIGGLRAMAVADSINGIGLVIGGLMVPVFGLIAMGKGSFMQGIEQLTTVHAEKL	YIDK_ECOLI	B
C6EFZ4_ECOBD	MSKEYMNDGSLSEKWKYRFNFYDQHGFPGFWGATPEYKAAFKALKVRQRLTIQMNFIAFFCSWIYLFVLGLWKKAIIVLLLGILSLFVGALIGVNILGIAVAAYVAVNTNKWFYEKEVKGLNTWSL	YIGF_ECOLI	B
C6EF84_ECOBD	MALLIITTILWAFSFSFYGEYLAGHVDSYFAVLVRVGLAALVFLPFLRTRGNSLKTVGLYMLVGAMQLGVMYMLSFRAYLYLTVSELLLFTVLTPLYITLIYDIMSKRRLRWGYAFSALLAVIGAGIIRYDQVTDHFWTGLLLVQLSNITFAIGMVGYKRLMETRPMPQHNAFAWFYLGAFLVAVIAWFLLGNAQKMPQTTLQWGILVFLGVVASGIGYFMWNYGATQVDAG	YIGM_ECOLI	B
C6EF41_ECOBD	MIRKSATGVIVALAVIWGGGTWYTGTQIQPGVEKFIKDFNDAKKKGEHAYDMTLSYKNFDKGFFNSRFQMQMTFDNGAPDLNIKPGQKVVFDVDVEHGPLPITMLMHGNVIPALAAAKVNLVNNELTQPLFIAAKNKSPVEATLRFAFGGSFSTTLDVAPAEYGKFSFGEGQFTFNGDGSSLSNLDIEGKVEDIVLQLSPMNKVTAKSFTIDSLARLEEKKFPVGESESKFN	YIHF_ECOLI	B
C6EF25_ECOBD	MSDHNPLTLKLNLWEKIAYGMGDVGSNLMLSIGTLYLLKFYTDELGMPAYYGGIIFLVAKFFTAFTDMLTGFLLDSRKNIGPKGKFRPFILYAAVPAALIATLQFIATTFSLPVKTTIATALFMMFGLSYSLMNCSYGAMIPAITKNPNERAQLAAYRQGGATIGLLICTVAFIPLQSLFSDSTVGYACAALMFSIGGFIFMMLCYRGVKEHYVDTAPTGHKASILKSFCAI	YIHO_ECOLI	B
C6EF24_ECOBD	MSHITTEDPATLRLPFKEKLSYGIGDLASNILLDIGTLYLLKFYTDVLGLPGTYGGIIFLISKFFTAFTDMGTGIMLDSRRKIGPKGKLRPFILYASFPVTLLAIANFVGTPFDVTGKTVMATILFMLYGLFFSMMNCSYGAMVPAITKNPNERASLAAWRQGGATLGLLLCTVGFVPVMNLIEGNQQLGYIFAATLFSLFGLLFMWICYSGVKERYVETQPANPAQKPGLL	YIHP_ECOLI	B
C6EE65_ECOBD	MSAAGKSNPLAISGLVVLTLIWSYSWIFMKQVTSYIGAFDFTALRCIFGALVLFIVLLLRGRGMRPTPFKYTLAIALLQTCGMVGLAQWALVSGGAGKVAILSYTMPFWVVIFAALFLGERLRRGQYFAILIAAFGLFLVLQPWQLDFSSMKSAMLAILSGVSWGASAIVAKRLYARHPRVDLLSLTSWQMLYAALVMSVVALLVPQREIDWQPTVFWALAYSAILATALAW	YIJE_ECOLI	B
C6EDZ4_ECOBD	MKRNLIKVVKMKPYFAALMLSVSVLPAYAGPLGTADKADLPQSNVSSPMMAQSLRQPDLQPISTDRKTECFRLYTPDRKPGVNCVPDGSTGH	YJBT_ECOLI	B
C6ED64_ECOBD	MATLTTGVVLLRWQLLSAVMMFLASTLNIRFRRSDYVGLAVISSGLGVVSACWFAMGLLGITMADITAIWHNIESVMIEEMNQTPPQWPMILT	YJCB_ECOLI	B
C6ED63_ECOBD	MSHRARHQLLALPGIIFLVLFPIILSLWIAFLWAKSEVNNQLRTFAQLALDKSELVIRQADLVSDAAERYQGQVCTPAHQKRMLNIIRGYLYINELIYARDNHFLCSSLIAPVNGYTIAPADYKREPNVSIYYYRDTPFFSGYKMTYMQRGNYVAVINPLFWSEVMSDDPTLQWGVYDTVTKTFFSLSKEASAATFSPLIHLKDLTVQRNGYLYATVYSTKRPIAAIVATSY	YJCC_ECOLI	B
C6ECZ4_ECOBD	MKTPSQPRAIYYIVAIQIWEYFSFYGMRALLILYLTHQLGFDDNHAISLFSAYASLVYVTPILGGWLADRLLGNRTAVIAGALLMTLGHVVLGIDTNSTFSLYLALAIIICGYGLFKSNISCLLGELYDENDHRRDGGFSLLYAAGNIGSIAAPIACGLAAQWYGWHVGFALAGGGMFIGLLIFLSGHRHFQSTRSMDKKALTSVKFALPVWSWLVVMLCLAPVFFTLLLEN	YJDL_ECOLI	B
C6ECZ6_ECOBD	MALFSKILIFYVIGVNISFVIIWFISHEKTHIRLLSAFLVGITWPMSLPVALLFSLF	YJDO_ECOLI	B
C6ECY4_ECOBD	MSGLKQELGLAQGIGLLSTSLLGTGVFAVPALAALVAGNNSLWAWPVLIILVFPIAIVFAILGRHYPSAGGVAHFVGMAFGSRLERVTGWLFLSVIPVGLPAALQIAAGFGQAMFGWHSWQLLLAELGTLALVWYIGTRGASSSANLQTVIAGLIVALIVAIWWAGDIKPASIPFPAPGNIELTGLFAALSVMFWCFVGLEAFAHLASEFKNPERDFPRALMIGLLLAGLVY	YJEH_ECOLI	B
C6ECW7_ECOBD	MPHTIKKMSLIGLILMIFTSVFGFANSPSAYYLMGYSAIPFYIFSALLFFIPFALMMAEMGAAYRKEEGGIYSWMNNSVGPRFAFIGTFMWFSSYIIWMVSTSAKVWVPFSTFLYGSDMTQHWRIAGLEPTQVVGLLAVAWMILVTVVASKGINKIARITAVGGIAVMCLNLVLLLVSITILLLNGGHFAQDINFLASPNPGYQSGLAMLSFVVFAIFAYGGIEAVGGLVDK	YJEM_ECOLI	B
C6ECB8_ECOBD	MIKRNLPLMITIGVFVLGYLYCLTQFPGFASTRVICNILTDNAFLGIIAVGMTFVILSGGIDLSVGSVIAFTGVFLAKVIGDFGLSPLLAFPLVLVMGCAFGAFMGLLIDALKIPAFIITLAGMFFLRGVSYLVSEESIPINHPIYDTLSSLAWKIPGGGRLSAMGLLMLAVVVIGIFLAHRTRFGNQVYAIGGNATSANLMGISTRSTTIRIYMLSTGLATLAGIVFSIYT	YJFF_ECOLI	B
C6ECG5_ECOBD	MHILDSLLAFSAYFFIGVAMVIIFLFIYSKITPHNEWQLIKNNNTAASLAFSGTLLGYVIPLSSAAINAVSIPDYFAWGGIALVIQLLVFAGVRLYMPALSEKIINHNTAAGMFMGTAALAGGIFNAACMTW	YJFL_ECOLI	B
C6ECG4_ECOBD	MARKRKSRNNSKIGHGAISRIGRPNNPFEPRRNRYAQKYLTLALMGGAAFFVLKGCSDSSDVDNDSDGTFYATVQDCIDDGNNADICARGWNNAKTAFYADVPKNMTQQNCQSKYENCYYDNVEQSWIPVVSGFLLSRVIRKDRDEPFVYNSGGSSFASRPVWRSTSGDYSWRSGSGKKESYSSGGFTTKKASTVSRGGYGRSSSARGHWGG	YJFM_ECOLI	B
C6EC94_ECOBD	MAQVINEMDVPSHSFVFHGTGERYFLICVVNVLLTIITLGIYLPWALMKCKRYLYANMEVNGQRFSYGITGGNVFFSCLVFVFFYFAILMTVSADMPLVGCVLTLSLLVLLIFMAAKGLRYQALMTSLNGVRFSFNCSMKGFWWVTFFLPILMAIGMGTVFFISTKMLHANSSSSVIISVVLMAIVGIVSIGIFNGTLYSLVMSFLWSNTSFGIHRFKVKLDTTYCIKYAIL	YJGN_ECOLI	B
C6EC79_ECOBD	MATAWYKQVNPPQRKALFSAWLGYVFDGFDFMMIFYILHIIKADLGITDIQATLIGTVAFIARPIGGGFFGAMADKYGRKPMMMWAIFIYSVGTGLSGIATNLYMLAVCRFIVGLGMSGEYACASTYAVESWPKNLQSKASAFLVSGFSVGNIIAAQIIPQFAEVYGWRNSFFIGLLPVLLVLWIRKSAPESQEWIEDKYKDKSTFLSVFRKPHLSISMIVFLVCFCLFGAN	YJHB_ECOLI	B
C6EBQ2_ECOBD	MDDCGAILHNIETKWLYDFLTLEKCRNFSQAAVSRNVSQPAFSRRIRALEQAIGVELFNRQVTPLQLSEQGKIFHSQIRHLLQQLESNLAELRGGSDYAQRKIKIAAAHSLSLGLLPSIISQMPPLFTWAIEAIDVDEAVDKLREGQSDCIFSFHDEDLLEAPFDHIRLFESQLFPVCASDEHGEALFNLAQPHFPLLNYSRNSYMGRLINRTLTRHSELSFSTFFVSSMSE	YJIE_ECOLI	B
C6EBQ0_ECOBD	MTTQVRKNVMDMFIDGARRGFTIATTNLLPNVVMAFVIIQALKITGLLDWVGHICEPVMALWGLPGEAATVLLAALMSMGGAVGVAASLATAGALTGHDVTVLLPAMYLMGNPVQNVGRCLGTAEVNAKYYPHIITVCVINALLSIWVMQLIV	YJIG_ECOLI	B
C6EBP9_ECOBD	MTQQGDAVAGELATEKVGIKGYLAFFLTIIFFSGVFSGTDSWWRVFDFSVLNGSFGQLPGANGATTSFRGAGGAGAKDGFLFALELAPSVILSLGIISITDGLGGLRAAQQLMTPVLKPLLGIPGICSLALIANLQNTDAAAGMTKELAQEGEITERDKVIFAAYQTSGSAIITNYFSSGVAVFAFLGTSVIVPLAVILVFKFVGANILRVWLNFEERRNPTQGAQA	YJIH_ECOLI	B
C6EBP7_ECOBD	MPSSTHPVERFSFSTALFGMLVLTLGMGLGRFLYTPMLPVMMAEGSFSFSQLSWIASGNYAGYLAGSLLFSFGAFHQPSRLRPFLLASALASGLLILAMAWLPPFILVLLIRVLAGVASAGMLIFGSTLIMQHTRHPFVLAALFSGVGIGIALGNEYVLAGLHFDLSSQTLWQGAGALSGMMLIALTLLMPSKKHAITPMPLAKTEQQIMSWWLLAILYGLAGFGYIIVATY	YJIJ_ECOLI	B
C6EBK7_ECOBD	MGVIEFLLALAQDMILAAIPAVGFAMVFNVPVRALRWCALLGSIGHGSRMILMTSGLNIEWSTFMASMLVGTIGIQWSRWYLAHPKVFTVAAVIPMFPGISAYTAMISAVKISQLGYSEPLMITLLTNFLTASSIVGALSIGLSIPGLWLYRKRPRV	YJJB_ECOLI	B
C6EBL3_ECOBD	MEKENITIDPRSSFTPSSSADIPVPPDGLVQRSTRIKRIQTTAMLLLFFAAVINYLDRSSLSVANLTIREELGLSATEIGALLSVFSLAYGIAQLPCGPLLDRKGPRLMLGLGMFFWSLFQAMSGMVHNFTQFVLVRIGMGIGEAPMNPCGVKVINDWFNIKERGRPMGFFNAASTIGVAVSPPILAAMMLVMGWRGMFITIGVLGIFLAIGWYMLYRNREHVELTAVEQAY	YJJL_ECOLI	B
C6EBL2_ECOBD	MSTMNVLICQQPKELVWKQREIPIPGDNEALIKIKSVGICGTDIHAWGGNQPFFSYPRVLGHEICGEIVGLGKNIADLKNGQQVAVIPYVACQQCPACKSGRTNCCEKISVIGVHQDGGFSEYLSVPVANILPADGIDPQAAALIEPFAISAHAVRRAAIAPGEQVLVVGAGPIGLGAAAIAKADGAQVVVADTSPARREHVATRLELPLLDPSAEDFDAQLRAQFGGSLAQ	YJJN_ECOLI	B
C6EBK6_ECOBD	MQTEQQRAVTRLCIQCGLFLLQHGAESALVDELSSRLGRALGMDSVESSISSNAIVLTTIKDGQCLTSTRKNHDRGINMHVVTEVQHIVILAEHHLLDYKGVEKRFSQIQPLRYPRWLVALMVGLSCACFCKLNNGGWDGAVITFFASTTAMYIRQLLAQRHLHPQINFCLTAFAATTISGLLLQLPTFSNTPTIAMAASVLLLVPGFPLINAVADMFKGHINTGLARWAIA	YJJP_ECOLI	B
C6EBK2_ECOBD	MLQRTLGSGWGVLLPGLLIAGLMYADLSSDQWRIVILMGLVLTPMMLYHKQLRHYILLPSCLALIAGIMLMIMNLNQG	YJJZ_ECOLI	B
C6ELS9_ECOBD	MEKYLHLLSRGDKIGLTLIRLSIAIVFMWIGLLKFVPYEADSITPFVANSPLMSFFYEHPEDYKQYLTHEGEYKPEARAWQTANNTYGFSNGLGVVEVIIALLVLANPVNRWLGLLGGLMAFTTPLVTLSFLITTPEAWVPALGDAHHGFPYLSGAGRLVLKDTLMLAGAVMIMADSAREILKQRSNESSSTLKTEY	YKGB_ECOLI	B
C6ELS6_ECOBD	MDALSRLLMLNAPQGTIDKNCVLGSDWQLPHGAGELSVIRWHALTQGAAKLEMPTGEIFTLRPGNVVLLPQNSAHRLSHVDNESTCIVCGTLRLQHSARYFLTSLPETLFLAPVNHSVEYNWLREAIPFLQQESRSAMPGVDALCSQICATFFTLAVREWIAQVNTEKNILSLLLHPRLGAVIQQMLEMPGHAWTVESLASIAHMSRASFAQLFRDVSGTTPLAVLTKLRLQ	YKGD_ECOLI	B
C6ELS1_ECOBD	MREQIKQDIDLIEILFYLKKKIRVILFIMAICMAMVLLFLYINKDNIKVIYSLKINQTTPGILVSCDSNNNFACQTTMTEDVIQRITTFFHTSPDVKNREIRLEWSGDKRALPTAEEEISRVQASIIKWYASEYHNGRQVLDEIQTPSAINSELYTKMIYLTRNWSLYPNGDGCVTISSPEIKNKYPAAICLALGFFLSIVISVMFCLVKKMVDEYQQNSGQ	YKGH_ECOLI	B
C6ELT2_ECOBD	MKENKVQQISHKLINIVVFVAIVEYAYLFLHFY	YKGR_ECOLI	B
C6EGW9_ECOBD	MSQDSKVFFRIFLGIGLVLILISVVVFYNQFTYSKDAIHTEGVIVDTVWHSSHSHRTGKDGSWYPVVAFRPTPDYTLIFNSSIGSDFYEDSEGDKVNVYYSPGHPEKAEINNPWVNFLNGGLSALWALFLSPSVY	YMFA_ECOLI	B
C6EC36_ECOBD	MGILSWIIFGLIAGILAKWIMPGKDGGGFFMTILLGIVGAVVGGWISTLFGFGKVDGFNFGSFVVAVIGAIVVLFIYRKIKS	YMGE_ECOLI	B
C6EGS2_ECOBD	MGIIAWIIFGLIAGIIAKLIMPGRDGGGFFLTCILGIVGAVVGGWLATMFGIGGSISGFNLHSFLVAVVGAILVLGIFRLLRRE	YMGE_ECOLI	B
C6EGU5_ECOBD	MNNSNNLDYFTLYIIFSIAFMLITLLVILIAKPSTGLGEVLVTINLLNALVWLAINLVNRLRERLVNHRDQQ	YMGF_ECOLI	B
C6EGU3_ECOBD	MADMNRTTKGALLGAGVGLLTGNGVNGVLKGAAVGAGVGAVTEKGRDGKNARKGAKVGAAVGAVTGVLTGNGLEGAIKGAVIGGTGGAILGKMK	YMGG_ECOLI	B
C6EFU7_ECOBD	MTYMKLTAAKRIVFFIYLFVIQFWKNASFQTKVS	YMIB_ECOLI	B
C6EFQ0_ECOBD	MIMAKLKSAKGKKFLFGLLAVFIIAASVVTRATIGGVIEQYNIPLSEWTTSMYVIQSSMIFVYSLVFTVLLAIPLGIYFLGGEEQ	YNAJ_ECOLI	B
C6EEV5_ECOBD	MTLYQIKPLFQSLLRPTMFWLYKHHVTANHITLAALALSLLTGLLLMLVAQPILFMLLPIVLFIRMALNALDGMLARECNQQTRLGAILNETGDVISDIALYLTFLFLPESNASLVILMLFCTILTEFCGLLAQTINGVRSYAGPFGKSDRALIFGLWGLAVAIYPQWMQWNNLLWSIASILLLWTAINRCRSVLLMSAEI	YNBA_ECOLI	B
C6EEV2_ECOBD	MITERRNVLLQGAGWLLLLAPFFFFTYGSLNQFTAVQDLNSHDIPSQVFGWETAIPFLPWTIVPYWSLDLLYGFSLFVCSTTFEQRRLVHRLILATVMACCGFLLYPLKFSFIRPEVSGVTGWLFSQLELFDLPYNQSPSLHIILCWLLWRHFRQHLAERWRKVCGGWFLLIAISTLTTWQHHFIDVITGLAVGMLIDWMVPVDRRWNYQKPDQRRIKIALPYVVGAGSCIV	YNBD_ECOLI	B
C6EEQ7_ECOBD	MVCFLIYITLLFIQRVYFISSEKKLTIHIVQMFQLLSQAFYNLKMFLMMDMLGVGDAININTNKNIRQVC	YNCH_ECOLI	B
C6EEK3_ECOBD	MIVRPQQHWLRRIFVWHGSVLSKISSRLLLNFLFSIAVIFMLPWYTHLGIKFTLAPFSILGVAIAIFLGFRNNAGYARYVEARKLWGQLMIASRSLLREVKTTLPDSASVREFARLQIAFAHCLRMTLRKQPQAEVLAHYLKTEDLQPVLASNSPANRILLIMGEWLAVQRRNGQLSDILFISLNDRLNDISAVLAGCERIAYTPIPFAYTLILHRTVYLFCIMLPFALVVD	YNEE_ECOLI	B
C6EDV2_ECOBD	MLGNMNVFMAVLGIILFSGFLAAYFSHKWDD	YNEM_ECOLI	B
C6EEL7_ECOBD	MHATTVKNKITQRDNYKEIMSAIVVVLLLTLTLIAIFSAIDQLSISEMGRIARDLTHFIINSLQG	YNEN_ECOLI	B
C6EDR6_ECOBD	MIKTTLLFFATALCEIIGCFLPWLWLKRNASIWLLLPAGISLALFVWLLTLHPAASGRVYAAYGGVYVCTALMWLRVVDGVKLTLYDWTGALIALCGMLIIVAGWGRT	YNFA_ECOLI	B
C6EDQ2_ECOBD	MSRTTTVDGAPASDTDKQSISQPNQFIKRGTPQFMRVTLALFSAGLATFALLYCVQPILPVLSQEFGLTPANSSISLSISTAMLAIGLLFTGPLSDAIGRKPVMVTALLLASICTLLSTMMTSWHGILIMRALIGLSLSGVAAVGMTYLSEEIHPSFVAFSMGLYISGNSIGGMSGRLISGVFTDFFNWRIALAAIGCFALASALMFWKILPESRHFRPTSLRPKTLFINFR	YNFM_ECOLI	B
C6ECN7_ECOBD	MPTKRFDKKHWKMVVVLLAICGAMLLLRWAAMIWG	YNID_ECOLI	B
C6ECK2_ECOBD	MATPLRYALIFLLWAMVAVIYAPLIPAALTLISPALSLTHWQALFADPQLPQALLATLVSTTIAAVGALLIALLVIVALWPGPKWQRMCARLPWLLAIPHVAFATSALLLFADGGLLYDYFPYFTPPMDRFGIGLGLTLAVKESAFLLWILAAVLSEKWLLQQVIVLDSLGYSRWQCLNWLLLPSVAPALAMAMLAIVAWSLSVVDVAIILGPGNPPTLAVISWQWLTQGDI	YNJC_ECOLI	B
C6ECJ9_ECOBD	MLDRHLHPRIKPLLHQCVRVLDKPGITPDGLTLVGFAIGVLALPFLALGWYLAALVVILLNRLLDGLDGALARRRELTDAGGFLDISLDFLFYALVPFGFILAAPEQNALAGGWLLFAFIGTGSSFLAFAALAAKHQIDNPGYAHKSFYYLGGLTEGTETILLFVLGCLFPAWFAWFAWIFGALCWMTTFTRVWSGYLTLKSLQRQ	YNJF_ECOLI	B
C6ECJ5_ECOBD	MKKVLLQNHPGSEKYSFNGWEIFNSNFERMIKENKAMLLCKWGFYLTCVVAVMFVFAAITSNGLNERGLITAGCSFLYLLIMMGLIVRAGFKAKKEQLHYYQAKGIEPLSIEKLQALQLIAPYRFYHKQWSETLEFWPRKPEPGKDTFQYHVLPFDSIDIISKRRESLEDQWGIEDSESYCALMEHFLSGDHGANTFKANMEEAPEQVIALLNKFAVFPSDYISDCANHSSG	YNJI_ECOLI	B
C6EC10_ECOBD	MTITDLVLILFIAALLAFAIYDQFIMPRRNGPTLLAIPLLRRGRIDSVIFVGLIVILIYNNVTNHGALITTWLLSALALMGFYIFWIRVPKIIFKQKGFFFANVWIEYSRIKAMNLSEDGVLVMQLEQRRLLIRVRNIDDLEKIYKLLVSTQ	YOBD_ECOLI	B
C6EAH6_ECOBD	MSHVWRLFSHPDREMQVINRENETISHHYTHHVLLMAAIPVICAFIGTTQIGWNFGDGTILKLSWFTGLALAVLFYGVMLAGVAVMGRVIWWMARNYPQRPSLAHCMVFAGYVATPLFLSGLVALYPLVWLCALVGTVALFYTGYLLYLGIPSFLNINKEEGLSFSSSTLAIGVLVLEVLLALTVILWGYGYRLF	YOHC_ECOLI	B
C6EAH0_ECOBD	MMANIWWSLPLTLIVFFAARKLAARYKFPLLNPLLVAMVVIIPFLMLTGISYDSYFKGSEVLNDLLQPAVVALAYPLYEQLHQIRARWKSIITICFIGSVVAMVTGTSVALLMGASPEIAASILPKSVTTPIAMAVGGSIGGIPAISAVCVIFVGILGAVFGHTLLNAMRIRTKAARGLAMGTASHALGTARCAELDYQEGAFSSLALVLCGIITSLIAPFLFPIILAVMG	YOHK_ECOLI	B
C6EAI4_ECOBD	MRIAKIWVIALFLFMALGGIGGVMLAGYTFILRAG	YOHO_ECOLI	B
C6E9Z1_ECOBD	MHTPIGVKPVAGSKEWREAWQKRAFAHISNGYKYIYIAINSPEIFLLVCSLIRI	YOJO_ECOLI	B
C6EKN7_ECOBD	MAELTALHTLTAQMKREGIRRLLVLSGEEGWCFEHTLKLRDALPGDWLWISPRPDAENHCSPSALQTLLGREFRHAVFDARHGFDAAAFAALSGTLKAGSWLVLLLPVWEEWENQPDADSLRWSDCPDPIATPHFVQHLKRVLTADNEAILWRQNQPFSLAHFTPRTDWYPATGAPQPEQQQLLKQLMTMPPGVAAVTAARGRGKSALAGQLISRIAGRAIVTAPAKASTDV	YPFI_ECOLI	B
C6EKN9_ECOBD	MDWLAKYWWILVIVFLVGVLLNVIKDLKRVDHKKFLANKPELPPHRDFNDKWDDDDDWPKKDQPKK	YPFN_ECOLI	B
C6EKG4_ECOBD	MNTLRYFDFGAARPVLLLIARIAVVLIFIIFGFPKMMGFDGTVQYMASLGAPMPMLAAIIAVVMEVPAAILIVLGFFTRPLAVLFIFYTLGTAVIGHHYWDMTGDAVGPNMINFWKNVSIAGAFLLLAITGPGAISLDRR	YPHA_ECOLI	B
C6EKG2_ECOBD	MKTMLAAYLPGNSTVDLREVAVPTPGINQVLIKMKSSGICGSDVHYIYHQHRATAAAPDKPLYQGFINGHEPCGQIVAMGQGCRHFKEGDRVLVYHISGCGFCPNCRRGFPISCTGKGKAAYGWQRDGGHAEYLLAEEKDLILLPDALSYEDGAFISCGVGTAYEGILRGEVSGSDNVLVVGLGPVGMMAMMLAKGRGAKRIIGVDMLPERLAMAKQLGVMDHGYLATTEGL	YPHC_ECOLI	B
C6EKG1_ECOBD	MSASSLPLPQGKSVSLKQFVSRHINEIGLLVVIAILYLVFSLNAPGFISLNNQMNVLRDAATIGIAAWAMTLIIISGEIDVSVGPMVAFVSVCLAFLLQFEVPLAVACLLVLLLGALMGTLAGVLRGVFNVPSFVATLGLWSALRGMGLFMTNALPVPIDENEVLDWLGGQFLGVPVSALIMIVLFALFVFISRKTAFGRSVFAVGGNATAAQLCGINVRRVRILIFTLSGL	YPHD_ECOLI	B
C6EJT7_ECOBD	MSEALSLFSLFASSFLSATLLPGNSEVVLVAMLLSGISHPWVLVLTATMGNSLGGLTNVILGRFFPLRKTSRWQEKATGWLKRYGAVTLLLSWMPVVGDLLCLLAGWMRISWGPVIFFLCLGKALRYVAVAAATVQGMMWWH	YQAA_ECOLI	B
C6EJV9_ECOBD	MGFWRIVITIILPPLGVLLGKGFGWAFIINILLTLLGYIPGLIHAFWVQTRD	YQAE_ECOLI	B
C6EJ98_ECOBD	MQHNSYRRWITLAIISFSGGVSFDLAYLRYIYQIPMAKFMGFSNTEIGLIMSTFGIAAIILYAPSGVIADKFSHRKMITSAMIITGLLGLLMATYPPLWVMLCIQIAFAITTILMLWSVSIKAASLLGDHSEQGKIMGWMEGLRGVGVMSLAVFTMWVFSRFAPDDSTSLKTVIIIYSVVYILLGILCWFFVSDNNNLRSANNEEKQSFQLSDILAVLRISTTWYCSMVIFG	YQCE_ECOLI	B
C6EIN3_ECOBD	MNIFTEAAKLEEQNCPFAMAQIVDSRGSTPRHSAQMLVRADGSIVGTIGGGMVERKVIEESLQALQERKPRLFHGRMARNGADAVGSDCGGAMSVFISVHGMRPRLVLIGAGHVNRAIAQSAALLGFDIAVADIYRESLNPELFPPSTTLLHAESFGAAVEALDIRPDNFVLIATNNQDREALDKLIEQPIAWLGLLASRRKVQLFLRQLREKGVAEEHIARLHAPVGYNIG	YQEB_ECOLI	B
C6EIK9_ECOBD	MVQKPLIKQGYSLAEEIANSVSHGIGLVFGIVGLVLLLVQAVDLNASATAITSYSLYGGSMILLFLASTLYHAIPHQRAKMWLKKFDHCAIYLLIAGTYTPFLLVGLDSPLARGLMIVIWSLALLGILFKLTIAHRFKILSLVTYLAMGWLSLVVIYEMAVKLAAGSVTLLAVGGVVYSLGVIFYVCKRIPYNHAIWHGFVLGGSVCHFLAIYLYIGQA	YQFA_ECOLI	B
C6EIM0_ECOBD	MNLLMRAIFSLLLLFTLSIPVISDCVAMAIESRFKYMMLLF	YQFG_ECOLI	B
C6EIE3_ECOBD	MVIGPFINASAVLLGGVLGALLSQRLPERIRVSMTSIFGLASLGIGILLVVKCANLPAMVLATLLGALIGEICLLEKGVNTAVAKAQNLFRHSRKKPAHESFIQNYVAIIVLFCASGTGIFGAMNEGMTGDPSILIAKSFLDFFTAMIFACSLGIAVSVISIPLLIIQLTLAWAAALILPLTTPSMMADFSAVGGLLLLATGLRICGIKMFPVVNMLPALLLAMPLSAAWTA	YQGA_ECOLI	B
C6EHU5_ECOBD	MILFADYNTPYLFAISFVLLIGLLEIFALICGHMLSGALDAHLDHYDSITTGHISQALHYLNIGRLPALVVLCLLAGFFGLIGILLQHACIMVWQSPLSNLFVVPVSLLFTIIAVHYTGKIVAPWIPRDHSSAITEEEYIGSMALITGHQATSGNPCEGKLTDQFGQIHYLLLEPEEGKIFTKGDKVLIICRLSATRYLAENNPWPQIL	YQIJ_ECOLI	B
C6EHU4_ECOBD	MDDIVNSVPSWMFTAIIAVCILFIIGIIFARLYRRASAEQAFVRTGLGGQKVVMSGGAIVMPIFHEIIPINMNTLKLEVSRSTIDSLITKDRMRVDVVVAFFVRVKPSVEGIATAAQTLGQRTLSPEDLRMLVEDKFVDALRATAAQMTMHELQDTRENFVQGVQNTVAEDLSKNGLELESVSLTNFNQTSKEHFNPNNAFDAEGLTKLTQETERRRRERNEVEQDVEVAVR	YQIK_ECOLI	B
C6EHP8_ECOBD	MELLTQLLQALWAQDFETLANPSMIGMLYFVLFVILFLENGLLPAAFLPGDSLLVLVGVLIAKGAMGYPQTILLLTVAASLGCWVSYIQGRWLGNTRTVQNWLSHLPAHYHQRAHHLFHKHGLSALLIGRFIAFVRTLLPTIAGLSGLNNARFQFFNWMSGLLWVLILTTLGYMLGKTPVFLKYEDQLMSCLMLLPVVLLVFGLAGSLVVLWKKKYGNRG	YQJA_ECOLI	B
C6EHP7_ECOBD	MQIPRMSLRQLAWSGAVLLLVGTLLLAWSAVRQQESTLAIRAVHQGTTMPDGFSIWHHLDAHGIPFKSITPKNDTLLITFDSSDQSAAAKAVLDRTLPHGYIIAQQDNNSQAMQWLTRLRDNSHRFG	YQJB_ECOLI	B
C6EHP2_ECOBD	MKKLEDVGVLVARILMPILFITAGWGKITGYAGTQQYMEAMGVPGFMLPLVILLEFGGGLAILFGFLTRTTALFTAGFTLLTAFLFHSNFAEGVNSLMFMKNLTISGGFLLLAITGPGAYSIDRLLNKKW	YQJF_ECOLI	B
C6EH74_ECOBD	MTGQSSSQAATPIQWWKPALFFLVVIAGLWYVKWQPYYGKAFTAAETHSIGKSILAQADANPWQAALDYAMIYFLAVWKAAVLGVILGSLIQVLIPRDWLLRTLGQSRFRGTLLGTLFSLPGMMCTCCAAPVAAGMRRQQVSMGGALAFWMGNPVLNPATLVFMGFVLGWGFAAIRLVAGLVMVLLIATLVQKWVRETPQTQAPVEIDIPEAQSGFFSRWGRALWTLFWSTI	YRAQ_ECOLI	B
C6EH31_ECOBD	MLLATALLIVGLLLVVYSADRLVFAASILCRTFGIPPLIIGMTVVSIGTSLPEVIVSLAASLHEQRDLAVGTALGSNIINILLILGLAALVRPFTVHSDVLRRELPLMLLVSVVAGSVLYDGQLSRSDGIFLLFLAVLWLLFIVKLARQAERQGTDSLTREQLAELPRDGGLPVAFLWLGIALIIMPVATRMVVDNATVLANYFAISELTMGLTAIAIGTSLPELATAIAGV	YRBG_ECOLI	B
C6EFI4_ECOBD	MRVKRWLLAGIALCLLTGMRDPFKPPEDLCRISELSQWRYQGMVGRGEHIIGVIKDGQKKWRRVQQNDVLENGWTILQLTPDALTLGTGTNCEPPQWLWQRQGDTNEAMDSRTTVDADTRRTGGKAAKSDADGG	YRFA_ECOLI	B
C6EFI3_ECOBD	MNMFFDWWFATSPRLRQLCWAVWLLMLVTLIFLSSTHHEERDALIRLRASHHQQWAALYRLVDTTPFSEEKTLPFSPLDFQLSGAQLVSWHPSAQGGELALKTLWEAVPSAFTRLAERNVSVSRFSLSVEGDDLLFTLQLETPHEG	YRFB_ECOLI	B
C6EFI2_ECOBD	MNPPINFLPWRQQRRTAFLRFWLLMFVAPLLLAVGITLILRLTGSAEARIDAVLLQAEQQLARSLQITKPRLLEQQQLREQRSQRQRQRQFTRDWQSALEALAALLPEHAWLTTISWQQGTLEIKGLTTSITALNALETSLRQDASFHLNQRGATQQDAQGRWQFEYQLTRKVSDEHVL	YRFC_ECOLI	B
C6ED41_ECOBD	MPTVLSRMAMQLKKTAWIIPVFMVSGCSLSPAIPVIGAYYPSWFFCAIASLILTLITRRVIQRANINLAFVGIIYTALFALYAMLFWLAFF	YTCA_ECOLI	B
C6ECD4_ECOBD	MISGVLYALLAGLMWGLIFVGPLIVPEYPAMLQSMGRYLALGLIALPIAWLGRVRLRQLARRDWLTALMLTMMGNLIYYFCLASAIQRTGAPVSTMIIGTLPVVIPVFANLLYSQRDGKLAWGKLAPALICIGIGLACVNIAELNHGLPDFDWARYTSGIVLALVSVVCWAWYALRNARWLRENPDKHPMMWATAQALVTLPVSLIGYLVACYWLNIQTPDFSLPFGPRPLV	YTFF_ECOLI	B
C6ECD2_ECOBD	MSQVSLSQQLKEGNLFAEQCPSREVLKHVTSRWGVLILVALREGTHRFSDLRRKIGGVSEKMLAQSLQALEQDGFLNRIAYPVVPPHVEYSLTPLGEQVSEKVAALADWIELNLPEVLAVRDERAA	YTFH_ECOLI	B
C6ECB9_ECOBD	MPQSLPDTTPPKRRFRWPTGMPQLAALLLVLLVDSLVAPHFWQVVLQDGRLFGSPIDILNRAAPVALLAIGMTLVIATGGIDLSVGAVMAIAGATTAAMTVAGFSLPIVLLSALGTGILAGLWNGILVAILKIQPFVATLILMVAGRGVAQLITSGQIVTFNSPDLSWFGSGSLLFLPTPVIIAVLTLILFWLLTRKTALGMFIEAVGINIRAAKNAGVNTRIIVMLTYVLS	YTFT_ECOLI	B
C6EBJ5_ECOBD	MFRWGIIFLVIALIAAALGFGGLAGTAAGAAKIVFVVGIILFLVSLFMGRKRP	YTJA_ECOLI	B
C6EJJ2_ECOBD	MAHSHSHTSSHLPEDNNARRLLYAFGVTAGFMLVEVVGGFLSGSLALLADAGHMLTDTAALLFALLAVQFSRRPPTIRHTFGWLRLTTLAAFVNAIALVVITILIVWEAIERFRTPRPVEGGMMMAIAVAGLLANILSFWLLHHGSEEKNLNVRAAALHVLGDLLGSVGAIIAALIIIWTGWTPADPILSILVSLLVLRSAWRLLKDSVNELLEGAPVSLDIAELKRRMCRE	ZITB_ECOLI	B
C6EBW8_ECOBD	MIELLFPGWLAGIMLACAAGPLGSFVVWRRMSYFGDTLAHASLLGVAFGLLLDVNPFYAVIAVTLLLAGGLVWLEKRPQLAIDTLLGIMAHSALSLGLVVVSLMSNIRVDLMAYLFGDLLAVTPEDLISIAIGVVIVVAILFWQWRNLLSMTISPDLAFVDGVKLQRVKLLLMLVTALTIGVAMKFVGALIITSLLIIPAATARRFARTPEQMAGVAVLVGMVAVTGGLTFS	ZNUB_ECOLI	B
C6EHV4_ECOBD	MSVPLILTILAGAATFIGAFLGVLGQKPSNRLLAFSLGFAAGIMLLISLMEMLPAALAAEGMSPVLGYGMFIFGLLGYFGLDRMLPHAHPQDLMQKSVQPLPKSIKRTAILLTLGISLHNFPEGIATFVTASSNLELGFGIALAVALHNIPEGLAVAGPVYAATGSKRTAILWAGISGLAEILGGVLAWLILGSMISPVVMAAIMAAVAGIMVALSVDELMPLAKEIDPNNN	ZUPT_ECOLI	B
C6EF80_ECOBD	MRKKEENLNTASGLRIAMILLGIAVTPVLLSSSSLGNQLSSSSLISVVLLGGVILTLLSAITISVGEKARLPTYGIVKYSFGEKGAIAINILMAISLFGWIAVTANMFGHSVHDLLAQHGLEVPLALLVAAGCVIFVASTAFGFTVLGKIAQVAVPVIALVLCYILYVATHTEVAVPAAIVEMNTGVAVSTVVGTIIVLVATLPDFGSFVHNRKHALIAAGVTFLVAYPLLY	CODB_ECOLI	B
C6EF66_ECOBD	MPGAPSFIALDWGTSSLRAWRFGESPNPQEKREFPWGIMKLPSQAATREDAFHDTFLRVCGDWLAQTPCPVLACGMLGSAQGWQPAAYLPCPVTLEGLAKQLTPVIHQQQTMLHIIPGVIKEGEMPEVMRGEETQIFGAISMEPALQNAIHQGMPVLIGLPGTHAKWAVVENNTITDFRTFMTGELFDVLSRHSILGATMHPGDEPHWDAFTHGLTAAQEHHQTGLLSTLFS	DGOK_ECOLI	B
C6ECE5_ECOBD	MNKIKNYRWHMIALVCFITVINYLDRTALGIAAPTIMETTGITKEQYSWIVSAFQLAYTLGQPVMGFFIDTVGLKLSFAICAAIWGLATMGHALTGTWSGLAFMRALMGFSEASAIPAGVKTASTWFPAKERGVATGVFNMGTSLGAMLAPPLIAWCIMFHSWQFAFIVSGSLALLAALFWFFCYKDPKDAKRLSDEERHYIESGQEQHLKTDKKEKTSIKHILSQRNFWGI	EXUT_ECOLI	B
C6EDC7_ECOBD	MSQDINNNIAVSKHRRIIRQLRWWMLILFLMGVTVNYITRNSLGILAPELKDSLGITTEQYSWIVGGFQLAYTLFQPLCGWLIDVIGLKIGFMICASLWGIACLLHAGAGSWIQLALLRFFMGGAEASATPANAKIIGEWFPKSERPVAAGWAGVGFSIGAMLAPPIIYFAHASFGWQGAFMFTGALAILWVFLWWACYNTPEEHPNLSKNELNFIRQDNEAPPVKMPFLTA	EXUT_ECOLI	B
C6EJB1_ECOBD	MLTKYALVAIIVLCFTVLGFTLMVGDSLCELSIRERGMEFKAVLAYESKK	HOKE_ECOLI	B
C6EKM8_ECOBD	MENLALTTLMLPFIGALVVSFSPQRRAAEWGFCSPH	HYFD_ECOLI	B
C6EEE2_ECOBD	MTLAELGMAFWHDLAAPVIAGILASMIVNWLNKRK	LDRD_ECOLI	B
C6EH92_ECOBD	MASNQTTLPNVSENEETLLTGVNENVYEDQSIGAELTKKDINRVAWRSMLLQASFNYERMQASGWLYGLLPALKKIHTNKRDLARAMKGHMGFFNTHPFLVTFVIGIILAMERSKQDVNSIQSTKIAVGAPLGGIGDAMFWLTLLPICGGIGASLALQGSILGAVVFIVLFNVVHLGLRFGLAHYAYRMGVAAIPLIKANTKKVGHAASIVGMTVIGALVATYVRLSTTLEI	PTPD_ECOLI	B
C6EBM1_ECOBD	MENSFKAALKAGRPQIGLWLGLSSSYSAELLAGAGFDWLLIDGEHAPNNVQTVLTQLQAIAPYPSQPVVRPSWNDPVQIKQLLDVGTQTLLVPMVQNADEAREAVRATRYPPAGIRGVGSALARASRWNRIPDYLQKANDQMCVLVQIETREAMKNLPQILDVEGVDGVFIGPADLSADMGYAGNPQHPEVQAAIEQAIVQIREAGKAPGILIANELLAKRYLELGALFVAV	RHMA_ECOLI	B
C6EBM2_ECOBD	MSDTSPAIPESIDPANQHKALTAGQQAVIKKLFRRLIVFLFVLFIFSFLDRINIGFAGLTMGRDLGLSATMFGLATTLFYAAYVIFGIPSNIMLSIVGARRWIATIMVLWGIASTATMFATGPTSLYVLRILVGITEAGFLPGILLYLTFWFPAYFRARANALFMVAMPVTTALGSIVSGYILSLDGVMALKGWQWLFLLEGFPSVLLGVMVWFWLDDSPDKAKWLTKEDKK	RHMT_ECOLI	B
C6EJF0_ECOBD	MTAELRNLPHIASMAFNEPLMLEPAYARVFFCALAGQLGISSLTDAVSGDSLTAQEALATLALSGDDDGPRQARSYQVMNGIAVLPVSGTLVSRTRALQPYSGMTGYNGIIARLQQAASDPMVDGILLDMDTPGGMVAGAFDCADIIARVRDIKPVWALANDMNCSAGQLLASAASRRLVTQTARTGSIGVMMAHSNYGAALEKQGVEITLIYSGSHKVDGNPYSHLPDDVR	SOHB_ECOLI	B
C6EB45_ECOBD	MNNKLARQGLLWSTIERLGTQAIQLLLMLYLGRVLGPSSFGYVGMLTLFLSLAQVLIDSGFSAALIRKSERTEKDYSTVFIFNICLSILIYIVLYCLSSYIALFYQIPLLESLLDILALTVIANGLTLIPKIQLTVDVNFKIQAKSSLIAITSSSVIAITLAALGYGVWTLVFQSLSYSVINCIVLNIYNPWYPKEKFCYETFKKLFSFSSNLLIAGVLEAFYSNIYQLIIG	WZXC_ECOLI	B
C6EFF5_ECOBD	MNSSTKIALVITLLDAMGIGLIMPVLPTLLREFIASEDIANHFGVLLALYALMQVIFAPWLGKMSDRFGRRPVLLLSLIGASLDYLLLAFSSALWMLYLGRLLSGITGATGAVAASVIADTTSASQRVKWFGWLGASFGLGLIAGPIIGGFAGEISPHSPFFIAALLNIVTFLVVMFWFRETKNTRDNTDTEVGVETQSNSVYITLFKTMPILLIIYFSAQLIGQIPATVWV	YAJR_ECOLI	B
C6EE94_ECOBD	MTSTPITTADIAKGKIDDALSVREKIGYGLGDAGGTVITCLIMNFLTFFYTDVFGLTPALVGTLFIALRVFDAISDPVMGVIADRTQSRWGRFRPWQLWIAIPIGIIGILTFTVPDASMGVKIAWAFGTYLLLSVGYTAINVPYCALINTMTTRHNEVISCQSWRFVLCGVAGFLVSVGLPWMVDLFGQGNAARGYQLGVGVLCAIAVVMFLCCFFWVRERVPLSTMGKFTL	YICJ_ECOLI	B
C6EBE7_ECOBD	MIKIFIGHYINVFYSTADITLKKQPLLFLAKLMVYSAALTFFTANFHCNMTRKINEYA		B
C6EBQ6_ECOBD	MPVNGIFDVFDMLSIYIIYKLIVSNNTWLIMRK		B
C6EC74_ECOBD	MISRWKWMLKQTIKKLWFRATLFAIVAIITALLSILFKSMIPESVSVKVGAEAVDNILNILASSMLAVTTFSLSIMVTAYGSATTNVTPRATRLVVEDVTTQNVLATFIGSFLLKWSTKTGHRVRVFPVSIFRFVWG		B
C6ECB0_ECOBD	MRLSGGYRSKYPLSPGNACHSGVLSVSMLFLLIFQPANSLKNLHNAVAPVIRTLCFLL		B
C6EDC4_ECOBD	MQHKVNEQFIRRSAWHSPVTSLLQNPDFFGPAIMAMMILPLFLPLLTPLSILGMLFTGVIFNNHRWRCPMRMPATLKCDDPSEDREETARFLGAWNYTRIRPGKARGAFFLGTQRGSDVGRELWLSQADLVRHIMFFSTTGGGKTETLFSLMLNSLCHARGFTMMDGKAQNDTARTIWYLALRFGREDDVEFINYMTGGRSRSELLHAGDKSLPESNSFNPFVYATETLVTE		B
C6EDU0_ECOBD	MDITPFLHALCAVAAQTLVGLFTGNWAYGAIAGCTFFIAREHTQAEYRWIEMFGHGKRINMPWWGGFDPRVWDVASLMDFAVPVVACLLIWLLVNRG		B
C6EE88_ECOBD	MCCLVFQQDEVYHIEIVELLAKLMNNSSKTSTVQIKRIKPSIIYRLLLIGLGSPMVIYGLVRPLTIETRD		B
C6EEK9_ECOBD	MRLNIADFKRRINALFKSSFLSAIADIAAFIP		B
C6EF70_ECOBD	MFESELLTQGFSTLLNNPQALLFATFGVMLGIVIGALPGLTATMGVAILLPFTYGMEPVSGLLMICGVFFGGVYGGSITAILLKIPGTPAAAATAIDGYELTKQGKAGLALSAATFSSFSGGTLSIIVLMFLSPVLASWALKFSASESFALATFGLSIIASISGESLIKGLIAGVGGLLIATIGLDPMGGFPRFTGGFVELMNVPFIPVMIGLFAASEAFRSMEQNQQIRQG		B
C6EFL8_ECOBD	MDISPLLHALCAVAAQILVGLFTGNWAYGAIAGCTFFIAREHTQAEYRWIEMFGHGKRMNMPWWGGFDPRAWDVASLMDFAVPVVACLLVWLLVNRG		B
C6EFV9_ECOBD	MIQRSSAQKSIDRENAPIQDQYFIFVLIIGYTLNGYYFVLR		B
C6EFZ6_ECOBD	MKSKPQKIILCLFLLCCIYNLWTLRPVQILYTYSDAGNSVFLVVDHLPWTDSDKINWYLNHQNEIKNQHPLPEGSWHTWYVIDIGNGFTDYKKYIEGPYEDLYCFPTIKSNDNCIVKNYLMVINEYPYRNTHIGINDFTEYQLTQENKIERVFNPHEFKKDNF		B
C6EG29_ECOBD	MPKTPRVYVAFCFYICNLNAALAMLGKFLEFAGMLCNLHIKWLIFAQDWWVWNGLSLLNKGLRGYTSANNFL		B
C6EGC6_ECOBD	MHLLAVYLIRTVRTNKLFIFKISIQFNILNMNVSVFKILHLSGLFLIFNASL		B
C6EGC8_ECOBD	MLAIPSSIAAFFVNGLLLVAHYFYSYFYSLLKKESFRN		B
C6EGJ2_ECOBD	MRQNVAHVSFSHHCGALFLLFPVYTQLIATRNRAQKLALLLLIRGWPQTGKRRFPNVL		B
C6EGR4_ECOBD	MYLHNKNNMRHFCITNKKKQKTSIFIFGQWVFWPIVVIVLLVIIFILPAYWSVINFDQL		B
C6EHV3_ECOBD	MFIAWYWIVLIALVVVGYFLHLKRYCRAFRQDRDALLEARNKYLNSTREETAEKVE		B
C6EIR9_ECOBD	MSVMNPISSNIFNAEFLNTPAAALAAWISIIGAVITLVTIVIRALFKYRKSHDVILKKSGIPAFILNFFLIRISLKRLPTITWAEKSITVLFSLLFLCAIYIFGPVFIQAIRTPPNSTLLYWIKSGESFYMSKKLATAATILTTPDWEISKDDCEESSSASTEKYKSLTIEHKEILCKLLTTDEGNTYIDEEVKNFVKDKFFIYSFAPTTIFILLWISLGFILTIHYSKKVR		B
C6EJ10_ECOBD	MHAGCGEVVKEKKSAASFDITAIFLLVMQVVVGGTQSFALDCEALCFSGVRQV		B
C6EK85_ECOBD	MHSHPLYAKSAIFPGSHCSLLLQNYSVSFVGITMAEAFYILIGFLIMAAIIVMAVLYLENHS		B
C6EKK5_ECOBD	MGLSKRQIFFHLKFYVFILTDVYPVWLRNKYKINIYVVMIYFYKLFPA		B
C6EL64_ECOBD	MCETGVAYAAPYSILHVIISLLHIDMLNPYFRIFSERVCYLLYPNFIQLRTGHE		B
C6EKS5_ECOBD	MNPYIYLGGAILAEVIGTTLMKFSEGFTRLWPSVGTIICYCASFWLLAQTLAYIPTGIAYGIWSGVGIVLISLLLWGFFGQRLDLPAIIGMMLICAGVLVINLLSRSTPH	EMRE_ECOLI	B
C6EFM7_ECOBD	MLSLPLTPGVAYGTSAGSAGYWFLQLLDRVTPSQWAAIGVLGSLVFGLLTYLTNLYFKIKEDKRKAARGE	ESSD_ECOLI	B
C6EA58_ECOBD	MLSRSDLLTLLTINFIVVTKGAERISEVSARFTLDAMPGKQMAIDADLNAGLINQAQAQTRRKDVASEADFYGAMDGASKFVRGDAIAGMMILAINLIGGVCIGIFKYNLSADAAFQQYVLMTIGDGLVAQIPSLLLSTAAAIIVTRVSDNGDIAHDVRHQLLASPSVLYTATGIMFVLAVVPGMPHLPFLLFSALLGFTGWRMSKQPLAAEAEEKSLETLTRTITETSEQQ	FHIA_ECOLI	B
C6EC80_ECOBD	MHIGQALDLVSRYDSLRNPLTSLGDYLDPELISRCLAESGTVTLRKRRLPLEMMVWCIVGMALERKEPLHQIVNRLDIMLPGNRPFVAPSAVIQARQRLGSEAVRRVFTKTAQLWHNATPHPHWCGLTLLAIDGVFWRTPDTPENDAAFPRQTHAGNPALYPQVKMVCQMELTSHLLTAAAFGTMKNSENELAEQLIEQTGDNTLTLMDKGYYSLGLLNAWSLAGEHRHWMI	INSG_ECOLI	B
C6EC81_ECOBD	MHLLVHPNGSKYWRLQYRYEGKQKMLALGVYPEITLADARVRRDETRKLLANGVDPGDKKKNDKVEQSKARTFKEVAIEWHGTNKKWSEDHAHRVLKSLEDNLFAALGERNIAELKTRDLLAPIKAVEMSGRLEVAARLQQRTTAIMRYAVQSGLIDYNPAQEMAGAVASCNRQHRPALELKRIPELLTKIDSYTGRPLTRWAIELTLLIFIRSSELRFARWSEIDFEASIW	INTB_ECOLI	B
C6EDX0_ECOBD	MLELLFVIGFFVMLMVTGVSLLGIIAALVVATAIMFLGGMLALMIKLLPWLLLAIAVVWVIKAIKAPKVPKYQRYDRWRY	PSPG_ECOLI	B
C6ED86_ECOBD	MLSQIQRFGGAMFTPVLLFPFAGIVVGLAILLQNPMFVGESLTDPNSLFAQIVHIIEEGGWTVFRNMPLIFAVGLPIGLAKQAQGRACLAVMVSFLTWNYFINAMGMTWGSYFGVDFTQDAVAGSGLTMMAGIKTLDTSIIGAIIISGIVTALHNRLFDKKLPVFLGIFQGTSYVVIIAFLVMIPCAWLTLLGWPKVQMGIESLQAFLRSAGALGVWVYTFLERILIPTGLH	PTXB_ECOLI	B
C6EFM2_ECOBD	MNTSHVRVVTHMCGFLVWLYSLSMLPPMVVALFYKEKSLFVFFITFVIFFCIGGGAWYTTKKSGIQLRTRDGFIIIVMFWILFSVISAFPLWIDSELNLTFIDALFEGVSGITTTGATVIDDVSSLPRAYLYYRSQLNFIGGLGVIVLAVAVLPLLGIGGAKLYQSEMPGPFKDDKLTPRLADTSRTLWITYSLLGIACIVCYRLAGMPLFDAICHGISTVSLGGFSTHSES	TRKG_ECOLI	B
C6EA41_ECOBD	MPAPVVLILAAGRGKRFLTSGGNTHKCIGWRQSPEVAPYRWPFEENGRTFDLAIEPQITTNDLRLMLRLALAGGGITIATQETFRPYIESGRLVSLLDDFLPQFPGFYLYFPQRRNIAPKLRALIDHVKEWRQQLA	YAGP_ECOLI	B
C6ELQ8_ECOBD	MNALSGLRMAQESVGLISVAHQAFVTIAGCGVNALSGLRMAQESVGLISVAHQAFATTAGCGVDALSGLRVARESVGLISVAHQAFVTIAGCGVNALSGLRVAREL	YAHH_ECOLI	B
C6EKW4_ECOBD	MLAISSNLSKMIIFIFAIIIIVVLCVITYLYLYKDESLVSKHYINYMAIPENDGVFTWLPDFFPHVAVDISIYTNVEDDYFFLIFP	YBBD_ECOLI	B
C6EJN2_ECOBD	MELKKLMEHISIIPDYRQTWKVKHKLSDILLLTIYAVVSGAEGWEDIEDFGETHPDFLKQYGDFENGIPVHDTIARVVSCICPAKFHESFINWMLDYHSSDDKDVIAIDGKIHRHSYDKSRRKGAIHVISAFSTMHSLVIGQIKTDKKSNEITAIPELLNMLDIKGKIIKTDAMGCQKDIAEKIQKQGGDYLFAVKGNQGRLNKAFEEKFPLKELNNPKHDSYAISEKSHGR	YBFD_ECOLI	B
C6EEQ4_ECOBD	MELKKMMEHISIIPDYRQAWKVEYKLSDILLLTICAVISGAEGWEDIEDFGETHLDFLKQYGDFENGIPVHDTIARVVSCISPAKFHECFINWMRDCHSSDDKDVIAIDGKTLRHSYDKSRRRGAIHVISAFSTMHSLVIGQIRTDEKSNEITAIPELLNMLDIKGKIITTDAMGCQKDIAEKIQKQGGDYLFAVKGNQGRLNKAFEEKFPLKELNNPAHDSYAMSEKSHGR	YDCC_ECOLI	B
C6EDU3_ECOBD	MDFQLYSLGAALVFHEIFFPESSTAMALILAMGTYGAGYVARIVGAFIFGKMGDRIGRKKVLFITITMMGICTTLIGVLPTYAQIGVFAPILLVTLRIIQGLGAGAEISGAGTMLAEYAPKGKRGIISSFVAMGTNCGTLSATAIWAFMFFILSKEELLAWGWRIPFLASVVVMVFAIWLRMNLKESPVFEKVNDSNQPTAKPAPAGSMFQSKSFWLATGLRFGQAGNSGLI	YDFJ_ECOLI	B
C6EEI2_ECOBD	MLLAGAIFVLTIVLVIWQPKGLGIGWSATLGAVLALVTGVVHPGDIPVVWNIVWNATAAFIAVIIISLLLDESGFFEWAALHVSRWGNGRGRLLFTWIVLLGAAVAALFANDGAALILTPIVIAMLLALGFSKGTTLAFVMAAGFIADTASLPLIVSNLVNIVSADFFGLGFREYASVMVPVDIAAIVATLVMLHLYFRKDIPQNYDMALLKSPAEAIKDPATFKTGWVVLL	YFJV_ECOLI	B
C6EJU5_ECOBD	MTKPNHELSPALIVLMSIATGLAVASNYYAQPLLDTIARNFSLSASSAGFIVTAAQLGYAAGLLFLVPLGDMFERRRLIVSMTLLAAGGMLITASSQSLAMMILGTALTGLFSVVAQILVPLAATLASPDKRGKVVGTIMSGLLLGILLARTVAGLLANLGGWRTVFWVASVLMALMALALWRGLPQMKSETHLNYPQLLGSVFSMFISDKILRTRALLGCLTFANFSILWT	YGAY_ECOLI	B
C6EIM4_ECOBD	MSGDILQTPDAPKPQGALDNYFKITARGSTVRQEVLAGLTTFLAMVYSVIVVPGMLGKAGFPPAAVFVATCLVAGFGSLLMGLWANLPMAIGCAISLTAFTAFSLVLGQQISVPVALGAVFLMGVIFTAISVTGVRTWILRNLPMGIAHGTGIGIGLFLLLIAANGVGMVIKNPIEGLPVALGAFTSFPVMMSLLGLAVIFGLEKCRVPGGILLVIIAISIIGLIFDPAVKY	YGFQ_ECOLI	B
C6EIH8_ECOBD	MKTKVAAIYGKRDVRLRVFELPEITDNELLVSVISDSVCLSTWKAALLGSEHKRVPDDLENHPVITGHECAGVIVEVGKNLTGKYKKGQRFVLQPAMGLPSGYSAGYSYEYFGGNATYMIIPEIAINLGCVLPYHGSYFAAASLAEPMCCIIGAYHANYHTTQYVYEHRMGVKPGGNIALLACAGPMGIGAIDYAINGGIQPSRVVVVDIDDKRLAQVQKLLPVELAASKGI	YGGP_ECOLI	B
C6EEK0_ECOBD	MELKKLMEHISIIPDYRQTWKVEHKLSDILLLTICAVISGAEGWEDIEDFGETHLDFLKQYGDFENGIPVHDTIARVVSCISPAKFHECFINWMRDCHSSDDKDVIAIDGKTLRHSYDKSRRRGAIHVISAFSTMHSLVIGQIKTDEKSNEITAIPELLNMLDIKGKIITTDAMGCQKDIAEKIQKQGGDYLFAVKGTQGRLNKAFEEKFPLKELNNPEHDSYAISEKSHGR	YHHI_ECOLI	B
C6EDW7_ECOBD	MHVHPISTFRLFQEGHLLRNSIAIFALTTLFYFIGAELRLVHELSLFWPLNGVMAGVFARYVWLNRLHYYAISYVAMLVYDAITTEWGLVSLAINFSNMMFIVTVALLVVRDKRLGKNKYEPVSALRLFNYCLIAALLCAIVGAIGSVSIDSLDFWPLLADWFSEQFSTGVLIVPCMLTLAIPGVLPRFKAEQMMPAIALIVSVIASVVIGGAGSLAFPLPALIWCAVRYTP	YNEF_ECOLI	B
C6EIH0_ECOBD	MVADPTTTLQVKNTGSLSVNRYGWINIWMAILGQFFTLFPLFFESCLILLKTWLEIFPDNAGILRIYLLQFSAIVGYKTRRAA	YQGD_ECOLI	B
C6EFE7_ECOBD	MQNRKWILTSLVMTFFGIPILAQFLAVVIAMLGVGLAGIIEVCNILITPTIYLLLKIFMLALGALMLFFSGRVGNVPEFCYVGYDGVGFAVIP	YZGL_ECOLI	B
C6EJ13_ECOBD	MKTGAEAIRALATQLPAFRQKLSDGWYQVRIAGRDVSTSGLTAQLHETLPDGAVIHIVPRVAGAKSGGVFQIVLGAAAIAGSFFTAGATLAAWGAAIGAGGMTGILFSLGASMVLGGVAQMLAPKARTPRIQTTDNGKQNTYFSSLDNMVAQGNVLPVLYGEMRVGSRVVSQEISTADEGDGGQVVVIGR		B
C6EKD7_ECOBD	MKSMDKLTTGVAYGTSAGSAGYWFLQLLDKVTPSQWAAIGVLGSLVFGLLTYLTNLYFKIKEDKRKAARGE		B
